30 100
TCCTTGTGCTTTATGTAAAATCCTACAACT|ATGATCTTGTCCTACAACTAATTCGGTTGA
AGTCCGGCCTCGATACGGAGCCCGTGAGAT|TACAACTAATTCGGTTGATCCGAGAGGTGC
CTTATTCACGTAGCTACAACTAATTCGGTT|ATCTCTTCCTTGTGCTTTATGTAAAATCCT
GGCTAACGTCTCAAGTCCGGCCTCGATACG|GCTCTTTGATGGCTACAACTAATTCGGTTG
CCGAGAGGTGGAGTTCGACTACAACTAATT|GCAAACAGGGATTTTCCGCATCTCTTGAGA
TCGTCCGCGCATAGGATCTCGCATGTCAAA|TTAACTTTCGCGCCTGGATATGGACTGTTA
GGTGATGATACGCGACTCACGGCGGACAGA|AGCGTGATGGTGAACACGGCGACTACTGCA
CGACAACGCCTATAGATAGCGAAGCCATCG|GATTTAACTCGTACCGACTCGTGGTAGGAC
ACATCAATTCGGTTTAGTTCCTACAACTAA|AGATACCTCCGTCCAGGCTTCGCTTCGCTA
TTTGATGGCTACAACTAATTCGGTTGATCC|GCTGGGTTATACGACTGAGTGTGAAAGATA
CGGAGCCCGTGAGATTAGATACCTCCGTCC|TGATCCGAGAGGTGCAGTACGTCTACAACC
TCTTGAGATGGCCGAATTATTGAGCGTGAT|CCTCCAGAGCCGTCGGATGTAAGTTGAGCG
ACAACTAATTCGGTTGATCCGAGAGGTGAT|GGTTGATCCGAGAGGTGGAATAAGCATCAA
TCCTTAGGGGGGACCCGCTTATGCAAACAG|TACAACTAATTCGGTTGATCCGAGAGGTGC
TTGATCCGAGAGGTGGAGTTCGACTACAAC|CTTATGCAAACAGGGATTTTCCGCATCTCT
CGTCGGATGTAAGTTGAGCGTGATTTGTCG|AGCGGATGGAATTTATAGCGAGGCGAGGAC
CTGCTCTTTGATGGCTACAACTAATTCGGT|CAACTTGCTGGGTTATACGACTGAGTGTGA
CGAGAGGTGATGAAATGGGAAGTGTCCTAT|TGATCCGAGAGGTGCGGGGTCATCTGTAAA
AGACCTGGTCTACTTATTCACGTAGCTACA|AAGTCTGAGCACATCTCTTCCTTGTGCTTT
GTGTTGTTATTAACTGACGACAACGCCTAT|CGGTTGATCCGAGAGGTGATTTAACTCGTA
TTCGGTTGATCCGAGAGGTGGAATAAGCAT|TTAGTTCCTACAACTAATTCGGTTGATCCG
CCCCGGGTCCATTGTCATTGCGCCCTATGG|TCTAGACGATTCCCGAAGTACAAGATGAAC
GGTTGATCCGAGAGGTGCGGGGTCATCTGT|ATTCGGTTGATCCGAGAGGTGACGATCTCA
TGGAATAAGCATCAAAGGGAACCTGCTCAC|TCGGTTGATCCGAGAGGTGTTCAGTACTAC
AACCCATTGCGTCATCTACAACTAATTCGG|GAGGTGGAGTTCGACTACAACTAATTCGGT
CCGACTCGTGGTAGGACACATTAACTTTCG|CTCACAGTTCCTACAACTAATTCGGTTGAT
ATCCGAGAGGTGCGGGGTCATCTGTAAAAC|GTTGATCCGAGAGGTGACGATCTCAATAAT
GATACGGAGCCCGTGAGATTAGATACCTCC|CGGTTGATCCGAGAGGTGCAGTACGTCTAC
CCATTGTCATTGCGCCCTATGGCAGACTGT|ATTCCCGAAGTACAAGATGAACCGTCAAGG
GAGGCTACAACTAATTCGGTTGATCCGAGA|ATGATACGCGACTCACGGCGGACAGAACGG
GTCGGATGTAAGTTGAGCGTGATTTGTCGA|GCGGATGGAATTTATAGCGAGGCGAGGACC
CCTGGTCTACTTATTCACGTAGCTACAACT|TCTGAGCACATCTCTTCCTTGTGCTTTATG
TTGGATGGCGCTACAACTAATTCGGTTGAT|CTATGGCAGACTGTTACGGAACCTTTCCAT
CGAGAGGTGGACAAACGGCTGGATTCCAGA|GCTAACGTCTCAAGTCCGGCCTCGATACGG
CTACAACTAATTCGGTTGATCCGAGAGGTG|TCGGTTGATCCGAGAGGTGGAATAAGCATC
GGATGGCGCTACAACTAATTCGGTTGATCC|ATGGCAGACTGTTACGGAACCTTTCCATAC
GCACATCTCTTCCTTGTGCTTTATGTAAAA|TCTTAATGTAATGATCTTGTCCTACAACTA
AACTAATTCGGTTGATCCGAGAGGTGATGA|TCTTGAGATGGCCGAATTATTGAGCGTGAT
TGGGTTATACGACTGAGTGTGAAAGATAGT|CTCCCGCTACAACTAATTCGGTTGATCCGA
TTACGAATCCCCCGGGTCCATTGTCATTGC|ACCCGCATGTCTAGACGATTCCCGAAGTAC
CCATCGCCTTCGTCCGCGCATAGGATCTCG|TAGGACACATTAACTTTCGCGCCTGGATAT
AGGTGGAATAAGCATCAAAGGGAACCTGCT|AATTCGGTTGATCCGAGAGGTGTTCAGTAC
GGTGATTTAACTCGTACCGACTCGTGGTAG|CATCAAAGGGAACCTGCTCACAGTTCCTAC
ATTCCAGACCAAGGGCCCCCGACATCAATT|CGATACGGAGCCCGTGAGATTAGATACCTC
CGCCCTATGGCAGACTGTTACGGAACCTTT|CAAGATGAACCGTCAAGGACTAGATCTCGC
TGTTATTAACTGACGACAACGCCTATAGAT|TGATCCGAGAGGTGATTTAACTCGTACCGA
TCGATTTACGAATCCCCCGGGTCCATTGTC|GACCCACCCGCATGTCTAGACGATTCCCGA
ATTCGGTTGATCCGAGAGGTGGAATAAGCA|TTTAGTTCCTACAACTAATTCGGTTGATCC
GGGGACCCGCTTATGCAAACAGGGATTTTC|ATTCGGTTGATCCGAGAGGTGCCTTTAACG
TGATCCGAGAGGTGATGAAATGGGAAGTGT|TCGGTTGATCCGAGAGGTGCGGGGTCATCT
TGATGGTGAACACGGCGACTACTGCAAGCC|AGCGTGATTTGTCGATTTACGAATCCCCCG
GTTGATCCGAGAGGTGTTCAGTACTACAAC|CAACTAATTCGGTTGATCCGAGAGGTGATG
ACGGCTGGATTCCAGACCAAGGGCCCCCGA|TCCGGCCTCGATACGGAGCCCGTGAGATTA
CGGTTGATCCGAGAGGTGCGGGGTCATCTG|AATTCGGTTGATCCGAGAGGTGACGATCTC
GGCTGCTCTTTGATGGCTACAACTAATTCG|ACCAACTTGCTGGGTTATACGACTGAGTGT
ACTAATTCGGTTGATCCGAGAGGTGATTTA|TGATCCGAGAGGTGGAATAAGCATCAAAGG
TCGGTTGATCCGAGAGGTGATGATACGCGA|ATGGCCGAATTATTGAGCGTGATGGTGAAC
GAACCTGCTCACAGTTCCTACAACTAATTC|GTTCAGTACTACAACTAATTCGGTTGATCC
ATCCGAGAGGTGGAATAAGCATCAAAGGGA|TACAACTAATTCGGTTGATCCGAGAGGTGT
GTGATGGTGAACACGGCGACTACTGCAAGC|GAGCGTGATTTGTCGATTTACGAATCCCCC
TCCGAGAGGTGTTGTTATTAACTGACGACA|AACTAATTCGGTTGATCCGAGAGGTGATTT
TTGTCATTGCGCCCTATGGCAGACTGTTAC|CCCGAAGTACAAGATGAACCGTCAAGGACT
CAACTAATTCGGTTGATCCGAGAGGTGATT|GTTGATCCGAGAGGTGGAATAAGCATCAAA
CTTAGGGGGGACCCGCTTATGCAAACAGGG|CAACTAATTCGGTTGATCCGAGAGGTGCCT
TTGATCCGAGAGGTGCGGGGTCATCTGTAA|TCGGTTGATCCGAGAGGTGACGATCTCAAT
TACCTCCGTCCAGGCTTCGCTTCGCTAGCT|CGTCTACAACCTACAACTAATTCGGTTGAT
TTTTCCGCATCTCTTGAGATGGCCGAATTA|TAACGGTCTCACCTCCAGAGCCGTCGGATG
CCTCCTCGCACACGCATCAGGTTGGATGGC|CGGGTCCATTGTCATTGCGCCCTATGGCAG
TGGATGGCGCTACAACTAATTCGGTTGATC|TATGGCAGACTGTTACGGAACCTTTCCATA
CCTACAACTAATTCGGTTGATCCGAGAGGT|AATTCGGTTGATCCGAGAGGTGGCTAACGT
TTATTGAGCGTGATGGTGAACACGGCGACT|ATGTAAGTTGAGCGTGATTTGTCGATTTAC
CGAATCCCCCGGGTCCATTGTCATTGCGCC|CGCATGTCTAGACGATTCCCGAAGTACAAG
GTGCCTTTAACGGTCTCACCTCCAGAGCCG|CCATTCTGACCCCAGTCACTTGCAGCCCAG
GACGACAACGCCTATAGATAGCGAAGCCAT|GTGATTTAACTCGTACCGACTCGTGGTAGG
ATTTAACTCGTACCGACTCGTGGTAGGACA|AAAGGGAACCTGCTCACAGTTCCTACAACT
TTGTTATTAACTGACGACAACGCCTATAGA|TTGATCCGAGAGGTGATTTAACTCGTACCG
TATCCTCTTAATGTAATGATCTTGTCCTAC|GGATTCCAGACCAAGGGCCCCCGACATCAA
TCGCACACGCATCAGGTTGGATGGCGCTAC|CCATTGTCATTGCGCCCTATGGCAGACTGT
AATGATCTTGTCCTACAACTAATTCGGTTG|GGGCCCCCGACATCAATTCGGTTTAGTTCC
TTATTAACTGACGACAACGCCTATAGATAG|ATCCGAGAGGTGATTTAACTCGTACCGACT
AGATTAGATACCTCCGTCCAGGCTTCGCTT|GTGCAGTACGTCTACAACCTACAACTAATT
GGTTGATCCGAGAGGTGTAATTCGGTTGAT|TCCGAGAGGTGAGGCTACAACTAATTCGGT
GATCCGAGAGGTGATGAAATGGGAAGTGTC|CGGTTGATCCGAGAGGTGCGGGGTCATCTG
CCTACAACTAATTCGGTTGATCCGAGAGGT|TCGCTTCGCTAGCTACAACTAATTCGGTTG
GCATCAAAGGGAACCTGCTCACAGTTCCTA|TCCGAGAGGTGTTCAGTACTACAACTAATT
ACTAATTCGGTTGATCCGAGAGGTGGACAA|GTTGATCCGAGAGGTGGCTAACGTCTCAAG
GTTGATCCGAGAGGTGATTTAACTCGTACC|AGGTGGAATAAGCATCAAAGGGAACCTGCT
CTAATTCGGTTGATCCGAGAGGTGTTGTTA|TGTAAAATCCTACAACTAATTCGGTTGATC
GCCCTATGGCAGACTGTTACGGAACCTTTC|AAGATGAACCGTCAAGGACTAGATCTCGCT
CTTCGCTAGCTACAACTAATTCGGTTGATC|ATTCGGTTGATCCGAGAGGTGTAATTCGGT
TATGGCTGCTCTTTGATGGCTACAACTAAT|AAAACCAACTTGCTGGGTTATACGACTGAG
TTCGACTACAACTAATTCGGTTGATCCGAG|TTCCGCATCTCTTGAGATGGCCGAATTATT
CGAGAGGTGCGGGGTCATCTGTAAAACCAA|GATCCGAGAGGTGACGATCTCAATAATGAC
CCGAGAGGTGACGATCTCAATAATGACGGG|GAACGGCTGCGTATCAACCCGGTATGAAAG
AGTTCCTACAACTAATTCGGTTGATCCGAG|AACTAATTCGGTTGATCCGAGAGGTGGCTA
AAAGGGAACCTGCTCACAGTTCCTACAACT|GAGGTGTTCAGTACTACAACTAATTCGGTT
AGGTTGGATGGCGCTACAACTAATTCGGTT|GCCCTATGGCAGACTGTTACGGAACCTTTC
ATTTACGAATCCCCCGGGTCCATTGTCATT|CCACCCGCATGTCTAGACGATTCCCGAAGT
GTAAAACCAACTTGCTGGGTTATACGACTG|CAATAATGACGGGCTCTCCCGCTACAACTA
GTGTCCTATGGCTGCTCTTTGATGGCTACA|ATCTGTAAAACCAACTTGCTGGGTTATACG
ATCTCGCATGTCAAAGTCTGAGCACATCTC|GGATATGGACTGTTAATATCCTCTTAATGT
ATCCGAGAGGTGGCTAACGTCTCAAGTCCG|GTCCTATGGCTGCTCTTTGATGGCTACAAC
GATCTCGCATGTCAAAGTCTGAGCACATCT|TGGATATGGACTGTTAATATCCTCTTAATG
CCTCGATACGGAGCCCGTGAGATTAGATAC|AATTCGGTTGATCCGAGAGGTGCAGTACGT
CGGTTGATCCGAGAGGTGCAGTACGTCTAC|GTGAAAGATAGTAACCCATTGCGTCATCTA
GCGTATCAACCCGGTATGAAAGTAAAGCTC|CTCGCACACGCATCAGGTTGGATGGCGCTA
ACAACTAATTCGGTTGATCCGAGAGGTGCC|GTTACGGAACCTTTCCATACAAGCCCCATT
AAGTCCGGCCTCGATACGGAGCCCGTGAGA|CTACAACTAATTCGGTTGATCCGAGAGGTG
TCCGAGAGGTGACGATCTCAATAATGACGG|AGAACGGCTGCGTATCAACCCGGTATGAAA
TCCTCGCACACGCATCAGGTTGGATGGCGC|GGTCCATTGTCATTGCGCCCTATGGCAGAC
ACTGTTAATATCCTCTTAATGTAATGATCT|AAACGGCTGGATTCCAGACCAAGGGCCCCC
TTGCTGGGTTATACGACTGAGTGTGAAAGA|GGCTCTCCCGCTACAACTAATTCGGTTGAT
CACATCTCTTCCTTGTGCTTTATGTAAAAT|CTTAATGTAATGATCTTGTCCTACAACTAA
ACTAATTCGGTTGATCCGAGAGGTGGAATA|TCGGTTTAGTTCCTACAACTAATTCGGTTG
AACTAATTCGGTTGATCCGAGAGGTGGAGT|GGGGGGACCCGCTTATGCAAACAGGGATTT
GTGATGATACGCGACTCACGGCGGACAGAA|GCGTGATGGTGAACACGGCGACTACTGCAA
GCTACAACTAATTCGGTTGATCCGAGAGGT|ATACGCGACTCACGGCGGACAGAACGGCTG
CTAATTCGGTTGATCCGAGAGGTGTTCAGT|GCTAGCTACAACTAATTCGGTTGATCCGAG
GGTGGAATAAGCATCAAAGGGAACCTGCTC|ATTCGGTTGATCCGAGAGGTGTTCAGTACT
TCCGCATCTCTTGAGATGGCCGAATTATTG|CGGTCTCACCTCCAGAGCCGTCGGATGTAA
ATCCGAGAGGTGCAGTACGTCTACAACCTA|GATAGTAACCCATTGCGTCATCTACAACTA
TGGCTGCTCTTTGATGGCTACAACTAATTC|AACCAACTTGCTGGGTTATACGACTGAGTG
GGTTTAGTTCCTACAACTAATTCGGTTGAT|GTCCAGGCTTCGCTTCGCTAGCTACAACTA
AAGCCTCCTCGCACACGCATCAGGTTGGAT|CCCCGGGTCCATTGTCATTGCGCCCTATGG
GGCTACAACTAATTCGGTTGATCCGAGAGG|TTATACGACTGAGTGTGAAAGATAGTAACC
GGAAGTGTCCTATGGCTGCTCTTTGATGGC|GGTCATCTGTAAAACCAACTTGCTGGGTTA
CAAACGGCTGGATTCCAGACCAAGGGCCCC|AAGTCCGGCCTCGATACGGAGCCCGTGAGA
AATTCGGTTGATCCGAGAGGTGTTGTTATT|TAAAATCCTACAACTAATTCGGTTGATCCG
TTCGGTTGATCCGAGAGGTGATTTAACTCG|CGAGAGGTGGAATAAGCATCAAAGGGAACC
ATACGGAGCCCGTGAGATTAGATACCTCCG|GGTTGATCCGAGAGGTGCAGTACGTCTACA
AGCACATCTCTTCCTTGTGCTTTATGTAAA|CTCTTAATGTAATGATCTTGTCCTACAACT
GGTTGATCCGAGAGGTGTTCAGTACTACAA|ACAACTAATTCGGTTGATCCGAGAGGTGAT
AATGGGAAGTGTCCTATGGCTGCTCTTTGA|GCGGGGTCATCTGTAAAACCAACTTGCTGG
ACTAATTCGGTTGATCCGAGAGGTGTAATT|TCGGTTGATCCGAGAGGTGAGGCTACAACT
GATTTGTCGATTTACGAATCCCCCGGGTCC|GGCGAGGACCCACCCGCATGTCTAGACGAT
AGAGGTGATGAAATGGGAAGTGTCCTATGG|ATCCGAGAGGTGCGGGGTCATCTGTAAAAC
AACTAATTCGGTTGATCCGAGAGGTGAGGC|ACTAATTCGGTTGATCCGAGAGGTGATGAT
TGGATATGGACTGTTAATATCCTCTTAATG|GAGGTGGACAAACGGCTGGATTCCAGACCA
ATTATTGAGCGTGATGGTGAACACGGCGAC|GATGTAAGTTGAGCGTGATTTGTCGATTTA
ACGTCTACAACCTACAACTAATTCGGTTGA|GTCATCTACAACTAATTCGGTTGATCCGAG
ATTCGGTTGATCCGAGAGGTGTAATTCGGT|TTGATCCGAGAGGTGAGGCTACAACTAATT
GTTTAGTTCCTACAACTAATTCGGTTGATC|TCCAGGCTTCGCTTCGCTAGCTACAACTAA
TTCGGTTGATCCGAGAGGTGTAATTCGGTT|TGATCCGAGAGGTGAGGCTACAACTAATTC
GTAAGTTGAGCGTGATTTGTCGATTTACGA|GAATTTATAGCGAGGCGAGGACCCACCCGC
ACGTAGCTACAACTAATTCGGTTGATCCGA|CCTTGTGCTTTATGTAAAATCCTACAACTA
GCTACAACTAATTCGGTTGATCCGAGAGGT|TATACGACTGAGTGTGAAAGATAGTAACCC
AATTCGGTTGATCCGAGAGGTGGCTAACGT|AATGGGAAGTGTCCTATGGCTGCTCTTTGA
AGGTGCCTTTAACGGTCTCACCTCCAGAGC|CCCCATTCTGACCCCAGTCACTTGCAGCCC
TGGCAGACTGTTACGGAACCTTTCCATACA|AACCGTCAAGGACTAGATCTCGCTTCCACC
GGTGACGATCTCAATAATGACGGGCTCTCC|CTGCGTATCAACCCGGTATGAAAGTAAAGC
TCCTACAACTAATTCGGTTGATCCGAGAGG|TTCGCTTCGCTAGCTACAACTAATTCGGTT
TCTTCCTTGTGCTTTATGTAAAATCCTACA|GTAATGATCTTGTCCTACAACTAATTCGGT
ACTAATTCGGTTGATCCGAGAGGTGATGAA|AGAGGTGTAATTCGGTTGATCCGAGAGGTG
CTCGTGGTAGGACACATTAACTTTCGCGCC|CAGTTCCTACAACTAATTCGGTTGATCCGA
AGAGGTGCCTTTAACGGTCTCACCTCCAGA|AGCCCCATTCTGACCCCAGTCACTTGCAGC
GGACCCGCTTATGCAAACAGGGATTTTCCG|TCGGTTGATCCGAGAGGTGCCTTTAACGGT
AGATAGTAACCCATTGCGTCATCTACAACT|GATCCGAGAGGTGGAGTTCGACTACAACTA
CCGAGAGGTGCAGTACGTCTACAACCTACA|TAGTAACCCATTGCGTCATCTACAACTAAT
CCGAGAGGTGTAATTCGGTTGATCCGAGAG|GGTGAGGCTACAACTAATTCGGTTGATCCG
ACAACTAATTCGGTTGATCCGAGAGGTGTT|TTTATGTAAAATCCTACAACTAATTCGGTT
CGGTTGATCCGAGAGGTGGAGTTCGACTAC|CCGCTTATGCAAACAGGGATTTTCCGCATC
ATTCGGTTGATCCGAGAGGTGCAGTACGTC|AGTGTGAAAGATAGTAACCCATTGCGTCAT
GTCTGAGCACATCTCTTCCTTGTGCTTTAT|ATATCCTCTTAATGTAATGATCTTGTCCTA
GGTTGATCCGAGAGGTGGAGTTCGACTACA|CGCTTATGCAAACAGGGATTTTCCGCATCT
CAACTAATTCGGTTGATCCGAGAGGTGGAC|CGGTTGATCCGAGAGGTGGCTAACGTCTCA
GTTCCTACAACTAATTCGGTTGATCCGAGA|GCTTCGCTTCGCTAGCTACAACTAATTCGG
CGTACCGACTCGTGGTAGGACACATTAACT|CCTGCTCACAGTTCCTACAACTAATTCGGT
TACAACTAATTCGGTTGATCCGAGAGGTGA|ACAACTAATTCGGTTGATCCGAGAGGTGAT
ACCGACTCGTGGTAGGACACATTAACTTTC|GCTCACAGTTCCTACAACTAATTCGGTTGA
CGCCTTCGTCCGCGCATAGGATCTCGCATG|ACACATTAACTTTCGCGCCTGGATATGGAC
CTGTAAAACCAACTTGCTGGGTTATACGAC|CTCAATAATGACGGGCTCTCCCGCTACAAC
ACCCATTGCGTCATCTACAACTAATTCGGT|AGGTGGAGTTCGACTACAACTAATTCGGTT
CGTGATTTGTCGATTTACGAATCCCCCGGG|CGAGGCGAGGACCCACCCGCATGTCTAGAC
AGTTCCTACAACTAATTCGGTTGATCCGAG|GGCTTCGCTTCGCTAGCTACAACTAATTCG
TTCGGTTGATCCGAGAGGTGAGGCTACAAC|TCGGTTGATCCGAGAGGTGATGATACGCGA
TAACCCATTGCGTCATCTACAACTAATTCG|AGAGGTGGAGTTCGACTACAACTAATTCGG
CCCGGTATGAAAGTAAAGCTCCTTAGGGGG|GCATCAGGTTGGATGGCGCTACAACTAATT
CGTATCAACCCGGTATGAAAGTAAAGCTCC|TCGCACACGCATCAGGTTGGATGGCGCTAC
GCTGCGTATCAACCCGGTATGAAAGTAAAG|CTCCTCGCACACGCATCAGGTTGGATGGCG
ATCTCTTGAGATGGCCGAATTATTGAGCGT|TCACCTCCAGAGCCGTCGGATGTAAGTTGA
CATGTCAAAGTCTGAGCACATCTCTTCCTT|GGACTGTTAATATCCTCTTAATGTAATGAT
GGATTTTCCGCATCTCTTGAGATGGCCGAA|CTTTAACGGTCTCACCTCCAGAGCCGTCGG
TGAGCGTGATTTGTCGATTTACGAATCCCC|ATAGCGAGGCGAGGACCCACCCGCATGTCT
TACTTATTCACGTAGCTACAACTAATTCGG|ACATCTCTTCCTTGTGCTTTATGTAAAATC
AATTCGGTTGATCCGAGAGGTGATGAAATG|GGTGTAATTCGGTTGATCCGAGAGGTGCGG
TTGAGCGTGATGGTGAACACGGCGACTACT|TAAGTTGAGCGTGATTTGTCGATTTACGAA
TTTACGAATCCCCCGGGTCCATTGTCATTG|CACCCGCATGTCTAGACGATTCCCGAAGTA
TGGCCGAATTATTGAGCGTGATGGTGAACA|GCCGTCGGATGTAAGTTGAGCGTGATTTGT
TGCAAGCCTCCTCGCACACGCATCAGGTTG|ATCCCCCGGGTCCATTGTCATTGCGCCCTA
TGGTAGGACACATTAACTTTCGCGCCTGGA|TCCTACAACTAATTCGGTTGATCCGAGAGG
TCCGAGAGGTGGAATAAGCATCAAAGGGAA|ACAACTAATTCGGTTGATCCGAGAGGTGTT
GCCGTCGGATGTAAGTTGAGCGTGATTTGT|CCAGCGGATGGAATTTATAGCGAGGCGAGG
GCTAACGTCTCAAGTCCGGCCTCGATACGG|CTCTTTGATGGCTACAACTAATTCGGTTGA
GAGGTGGAATAAGCATCAAAGGGAACCTGC|TAATTCGGTTGATCCGAGAGGTGTTCAGTA
TGGACAAACGGCTGGATTCCAGACCAAGGG|TCTCAAGTCCGGCCTCGATACGGAGCCCGT
AGGTGGACAAACGGCTGGATTCCAGACCAA|ACGTCTCAAGTCCGGCCTCGATACGGAGCC
TTCGGTTGATCCGAGAGGTGTTGTTATTAA|AAATCCTACAACTAATTCGGTTGATCCGAG
AGAGGTGGAGTTCGACTACAACTAATTCGG|AACAGGGATTTTCCGCATCTCTTGAGATGG
TTGATCCGAGAGGTGAGGCTACAACTAATT|TGATCCGAGAGGTGATGATACGCGACTCAC
TATGTAAAATCCTACAACTAATTCGGTTGA|CTACAACTAATTCGGTTGATCCGAGAGGTG
CCGAATTATTGAGCGTGATGGTGAACACGG|GTCGGATGTAAGTTGAGCGTGATTTGTCGA
TCCTACAACTAATTCGGTTGATCCGAGAGG|ATTCGGTTGATCCGAGAGGTGGAATAAGCA
TGCTCTTTGATGGCTACAACTAATTCGGTT|AACTTGCTGGGTTATACGACTGAGTGTGAA
TTGATCCGAGAGGTGGACAAACGGCTGGAT|GAGGTGGCTAACGTCTCAAGTCCGGCCTCG
ATGTAAAATCCTACAACTAATTCGGTTGAT|TACAACTAATTCGGTTGATCCGAGAGGTGG
CACGGCGGACAGAACGGCTGCGTATCAACC|GGCGACTACTGCAAGCCTCCTCGCACACGC
GTTATTAACTGACGACAACGCCTATAGATA|GATCCGAGAGGTGATTTAACTCGTACCGAC
GACTCGTGGTAGGACACATTAACTTTCGCG|CACAGTTCCTACAACTAATTCGGTTGATCC
CTCCCGCTACAACTAATTCGGTTGATCCGA|AAGCTCCTTAGGGGGGACCCGCTTATGCAA
CCCGTGAGATTAGATACCTCCGTCCAGGCT|CGAGAGGTGCAGTACGTCTACAACCTACAA
GTGTTCAGTACTACAACTAATTCGGTTGAT|TGATCCGAGAGGTGATGAAATGGGAAGTGT
GACTGAGTGTGAAAGATAGTAACCCATTGC|AACTAATTCGGTTGATCCGAGAGGTGGAGT
GAGTGTGAAAGATAGTAACCCATTGCGTCA|AATTCGGTTGATCCGAGAGGTGGAGTTCGA
TGATCCGAGAGGTGCAGTACGTCTACAACC|AAGATAGTAACCCATTGCGTCATCTACAAC
ATCCTCTTAATGTAATGATCTTGTCCTACA|GATTCCAGACCAAGGGCCCCCGACATCAAT
CGGTTTAGTTCCTACAACTAATTCGGTTGA|CGTCCAGGCTTCGCTTCGCTAGCTACAACT
TGCTTTATGTAAAATCCTACAACTAATTCG|TTGTCCTACAACTAATTCGGTTGATCCGAG
GAATCCCCCGGGTCCATTGTCATTGCGCCC|GCATGTCTAGACGATTCCCGAAGTACAAGA
ATTTTCCGCATCTCTTGAGATGGCCGAATT|TTAACGGTCTCACCTCCAGAGCCGTCGGAT
CCCCCGACATCAATTCGGTTTAGTTCCTAC|GAGATTAGATACCTCCGTCCAGGCTTCGCT
TCTCACCTCCAGAGCCGTCGGATGTAAGTT|AGTCACTTGCAGCCCAGCGGATGGAATTTA
TGAAATGGGAAGTGTCCTATGGCTGCTCTT|GGTGCGGGGTCATCTGTAAAACCAACTTGC
CTACAACTAATTCGGTTGATCCGAGAGGTG|TACGCGACTCACGGCGGACAGAACGGCTGC
CCGCGCATAGGATCTCGCATGTCAAAGTCT|CTTTCGCGCCTGGATATGGACTGTTAATAT
TATTGAGCGTGATGGTGAACACGGCGACTA|TGTAAGTTGAGCGTGATTTGTCGATTTACG
ATCTTGTCCTACAACTAATTCGGTTGATCC|CCCCGACATCAATTCGGTTTAGTTCCTACA
AAAGTAAAGCTCCTTAGGGGGGACCCGCTT|TGGATGGCGCTACAACTAATTCGGTTGATC
CGAGAGGTGTTCAGTACTACAACTAATTCG|TTCGGTTGATCCGAGAGGTGATGAAATGGG
CGGCTGCGTATCAACCCGGTATGAAAGTAA|GCCTCCTCGCACACGCATCAGGTTGGATGG
ATAGCGAAGCCATCGCCTTCGTCCGCGCAT|GACTCGTGGTAGGACACATTAACTTTCGCG
GATGGCCGAATTATTGAGCGTGATGGTGAA|GAGCCGTCGGATGTAAGTTGAGCGTGATTT
TAATTCGGTTGATCCGAGAGGTGGAGTTCG|GGGACCCGCTTATGCAAACAGGGATTTTCC
ATTGCGCCCTATGGCAGACTGTTACGGAAC|AGTACAAGATGAACCGTCAAGGACTAGATC
ATCCGAGAGGTGATGAAATGGGAAGTGTCC|GGTTGATCCGAGAGGTGCGGGGTCATCTGT
ATATGGACTGTTAATATCCTCTTAATGTAA|GTGGACAAACGGCTGGATTCCAGACCAAGG
CGCGCCTGGATATGGACTGTTAATATCCTC|ATCCGAGAGGTGGACAAACGGCTGGATTCC
TCCAGACCAAGGGCCCCCGACATCAATTCG|ATACGGAGCCCGTGAGATTAGATACCTCCG
AATCCTACAACTAATTCGGTTGATCCGAGA|TAATTCGGTTGATCCGAGAGGTGGAATAAG
GGTGCAGTACGTCTACAACCTACAACTAAT|CCCATTGCGTCATCTACAACTAATTCGGTT
GATTAGATACCTCCGTCCAGGCTTCGCTTC|TGCAGTACGTCTACAACCTACAACTAATTC
GTCGATTTACGAATCCCCCGGGTCCATTGT|GGACCCACCCGCATGTCTAGACGATTCCCG
AGCGTGATTTGTCGATTTACGAATCCCCCG|AGCGAGGCGAGGACCCACCCGCATGTCTAG
GGTGGAGTTCGACTACAACTAATTCGGTTG|AGGGATTTTCCGCATCTCTTGAGATGGCCG
TAAAACCAACTTGCTGGGTTATACGACTGA|AATAATGACGGGCTCTCCCGCTACAACTAA
ATTCGGTTGATCCGAGAGGTGATTTAACTC|CCGAGAGGTGGAATAAGCATCAAAGGGAAC
CAACTAATTCGGTTGATCCGAGAGGTGCCT|TTACGGAACCTTTCCATACAAGCCCCATTC
TGTAATTCGGTTGATCCGAGAGGTGCGGGG|TACAACTAATTCGGTTGATCCGAGAGGTGA
TTCGCTTCGCTAGCTACAACTAATTCGGTT|ACTAATTCGGTTGATCCGAGAGGTGTAATT
CCTCCAGAGCCGTCGGATGTAAGTTGAGCG|CTTGCAGCCCAGCGGATGGAATTTATAGCG
TGATCCGAGAGGTGACGATCTCAATAATGA|GACAGAACGGCTGCGTATCAACCCGGTATG
CGCTACAACTAATTCGGTTGATCCGAGAGG|TCCTTAGGGGGGACCCGCTTATGCAAACAG
GTCTCACCTCCAGAGCCGTCGGATGTAAGT|CAGTCACTTGCAGCCCAGCGGATGGAATTT
GCTTTATGTAAAATCCTACAACTAATTCGG|TGTCCTACAACTAATTCGGTTGATCCGAGA
GTCCTACAACTAATTCGGTTGATCCGAGAG|ACATCAATTCGGTTTAGTTCCTACAACTAA
AGCCTCCTCGCACACGCATCAGGTTGGATG|CCCGGGTCCATTGTCATTGCGCCCTATGGC
TCCGAGAGGTGGACAAACGGCTGGATTCCA|TGGCTAACGTCTCAAGTCCGGCCTCGATAC
TGTAATGATCTTGTCCTACAACTAATTCGG|CAAGGGCCCCCGACATCAATTCGGTTTAGT
GGAGTTCGACTACAACTAATTCGGTTGATC|GATTTTCCGCATCTCTTGAGATGGCCGAAT
GCACACGCATCAGGTTGGATGGCGCTACAA|ATTGTCATTGCGCCCTATGGCAGACTGTTA
TGAACACGGCGACTACTGCAAGCCTCCTCG|ATTTGTCGATTTACGAATCCCCCGGGTCCA
TGTAAAATCCTACAACTAATTCGGTTGATC|ACAACTAATTCGGTTGATCCGAGAGGTGGA
TTAGATACCTCCGTCCAGGCTTCGCTTCGC|CAGTACGTCTACAACCTACAACTAATTCGG
CTCACAGTTCCTACAACTAATTCGGTTGAT|ACTACAACTAATTCGGTTGATCCGAGAGGT
ATGATACGCGACTCACGGCGGACAGAACGG|TGATGGTGAACACGGCGACTACTGCAAGCC
TTCGGTTGATCCGAGAGGTGGACAAACGGC|TCCGAGAGGTGGCTAACGTCTCAAGTCCGG
AAGATAGTAACCCATTGCGTCATCTACAAC|TGATCCGAGAGGTGGAGTTCGACTACAACT
CGAGAGGTGATGATACGCGACTCACGGCGG|TATTGAGCGTGATGGTGAACACGGCGACTA
CTGTTAATATCCTCTTAATGTAATGATCTT|AACGGCTGGATTCCAGACCAAGGGCCCCCG
GCGCCCTATGGCAGACTGTTACGGAACCTT|ACAAGATGAACCGTCAAGGACTAGATCTCG
ACTGACGACAACGCCTATAGATAGCGAAGC|GAGGTGATTTAACTCGTACCGACTCGTGGT
GGTGTTCAGTACTACAACTAATTCGGTTGA|TTGATCCGAGAGGTGATGAAATGGGAAGTG
TACAACTAATTCGGTTGATCCGAGAGGTGC|TACGACTGAGTGTGAAAGATAGTAACCCAT
CAAGACCTGGTCTACTTATTCACGTAGCTA|CAAAGTCTGAGCACATCTCTTCCTTGTGCT
AACTAATTCGGTTGATCCGAGAGGTGCAGT|GACTGAGTGTGAAAGATAGTAACCCATTGC
CTCCAGAGCCGTCGGATGTAAGTTGAGCGT|TTGCAGCCCAGCGGATGGAATTTATAGCGA
TCGGTTGATCCGAGAGGTGTAATTCGGTTG|GATCCGAGAGGTGAGGCTACAACTAATTCG
GAGCGTGATTTGTCGATTTACGAATCCCCC|TAGCGAGGCGAGGACCCACCCGCATGTCTA
AGGTGACGATCTCAATAATGACGGGCTCTC|GCTGCGTATCAACCCGGTATGAAAGTAAAG
TCACCTCCAGAGCCGTCGGATGTAAGTTGA|TCACTTGCAGCCCAGCGGATGGAATTTATA
CTTTGATGGCTACAACTAATTCGGTTGATC|TGCTGGGTTATACGACTGAGTGTGAAAGAT
GTCATCTACAACTAATTCGGTTGATCCGAG|TCGACTACAACTAATTCGGTTGATCCGAGA
TGCAAACAGGGATTTTCCGCATCTCTTGAG|GAGAGGTGCCTTTAACGGTCTCACCTCCAG
ATCCTACAACTAATTCGGTTGATCCGAGAG|AATTCGGTTGATCCGAGAGGTGGAATAAGC
CCTTCGTCCGCGCATAGGATCTCGCATGTC|ACATTAACTTTCGCGCCTGGATATGGACTG
GTCCGGCCTCGATACGGAGCCCGTGAGATT|ACAACTAATTCGGTTGATCCGAGAGGTGCA
AACTAATTCGGTTGATCCGAGAGGTGTAAT|TTCGGTTGATCCGAGAGGTGAGGCTACAAC
TATGAAAGTAAAGCTCCTTAGGGGGGACCC|AGGTTGGATGGCGCTACAACTAATTCGGTT
ACCTACAACTAATTCGGTTGATCCGAGAGG|AACTAATTCGGTTGATCCGAGAGGTGAGGC
CGGGGTCATCTGTAAAACCAACTTGCTGGG|GGTGACGATCTCAATAATGACGGGCTCTCC
CGACTACAACTAATTCGGTTGATCCGAGAG|CCGCATCTCTTGAGATGGCCGAATTATTGA
CCAAGACCTGGTCTACTTATTCACGTAGCT|TCAAAGTCTGAGCACATCTCTTCCTTGTGC
TCCGAGAGGTGTAATTCGGTTGATCCGAGA|AGGTGAGGCTACAACTAATTCGGTTGATCC
CAAGCCTCCTCGCACACGCATCAGGTTGGA|CCCCCGGGTCCATTGTCATTGCGCCCTATG
TTCGTCCGCGCATAGGATCTCGCATGTCAA|ATTAACTTTCGCGCCTGGATATGGACTGTT
TAGGGGGGACCCGCTTATGCAAACAGGGAT|ACTAATTCGGTTGATCCGAGAGGTGCCTTT
GTTGATCCGAGAGGTGTTGTTATTAACTGA|CCTACAACTAATTCGGTTGATCCGAGAGGT
GAAGCCATCGCCTTCGTCCGCGCATAGGAT|GTGGTAGGACACATTAACTTTCGCGCCTGG
TCACGTAGCTACAACTAATTCGGTTGATCC|TTCCTTGTGCTTTATGTAAAATCCTACAAC
TCCGAGAGGTGAGGCTACAACTAATTCGGT|CCGAGAGGTGATGATACGCGACTCACGGCG
ATCTCAATAATGACGGGCTCTCCCGCTACA|TCAACCCGGTATGAAAGTAAAGCTCCTTAG
GGTAGGACACATTAACTTTCGCGCCTGGAT|CCTACAACTAATTCGGTTGATCCGAGAGGT
ACTAATTCGGTTGATCCGAGAGGTGATGAT|CTTGAGATGGCCGAATTATTGAGCGTGATG
GTATGAAAGTAAAGCTCCTTAGGGGGGACC|CAGGTTGGATGGCGCTACAACTAATTCGGT
GTTGGATGGCGCTACAACTAATTCGGTTGA|CCTATGGCAGACTGTTACGGAACCTTTCCA
TAGATAGCGAAGCCATCGCCTTCGTCCGCG|ACCGACTCGTGGTAGGACACATTAACTTTC
AACCCGGTATGAAAGTAAAGCTCCTTAGGG|ACGCATCAGGTTGGATGGCGCTACAACTAA
ACTCGTGGTAGGACACATTAACTTTCGCGC|ACAGTTCCTACAACTAATTCGGTTGATCCG
ACCAAGACCTGGTCTACTTATTCACGTAGC|GTCAAAGTCTGAGCACATCTCTTCCTTGTG
ATGTAAGTTGAGCGTGATTTGTCGATTTAC|TGGAATTTATAGCGAGGCGAGGACCCACCC
GTTGATCCGAGAGGTGCGGGGTCATCTGTA|TTCGGTTGATCCGAGAGGTGACGATCTCAA
GGTGCCTTTAACGGTCTCACCTCCAGAGCC|CCCATTCTGACCCCAGTCACTTGCAGCCCA
ATGGGAAGTGTCCTATGGCTGCTCTTTGAT|CGGGGTCATCTGTAAAACCAACTTGCTGGG
CCGAGAGGTGCCTTTAACGGTCTCACCTCC|ACAAGCCCCATTCTGACCCCAGTCACTTGC
AAAGATAGTAACCCATTGCGTCATCTACAA|TTGATCCGAGAGGTGGAGTTCGACTACAAC
GTCCAGGCTTCGCTTCGCTAGCTACAACTA|AACCTACAACTAATTCGGTTGATCCGAGAG
ATTGTCATTGCGCCCTATGGCAGACTGTTA|TCCCGAAGTACAAGATGAACCGTCAAGGAC
TGATCTTGTCCTACAACTAATTCGGTTGAT|GCCCCCGACATCAATTCGGTTTAGTTCCTA
ATGCAAACAGGGATTTTCCGCATCTCTTGA|CGAGAGGTGCCTTTAACGGTCTCACCTCCA
ACGTCTCAAGTCCGGCCTCGATACGGAGCC|TTGATGGCTACAACTAATTCGGTTGATCCG
CGGACAGAACGGCTGCGTATCAACCCGGTA|CTACTGCAAGCCTCCTCGCACACGCATCAG
CAACTAATTCGGTTGATCCGAGAGGTGATG|CTCTTGAGATGGCCGAATTATTGAGCGTGA
TTCCTACAACTAATTCGGTTGATCCGAGAG|CTTCGCTTCGCTAGCTACAACTAATTCGGT
GTTGATCCGAGAGGTGTAATTCGGTTGATC|CCGAGAGGTGAGGCTACAACTAATTCGGTT
TAACTTTCGCGCCTGGATATGGACTGTTAA|TCGGTTGATCCGAGAGGTGGACAAACGGCT
GGCCGAATTATTGAGCGTGATGGTGAACAC|CCGTCGGATGTAAGTTGAGCGTGATTTGTC
GCCTATAGATAGCGAAGCCATCGCCTTCGT|CTCGTACCGACTCGTGGTAGGACACATTAA
CGTCCAGGCTTCGCTTCGCTAGCTACAACT|CAACCTACAACTAATTCGGTTGATCCGAGA
AATTCGGTTGATCCGAGAGGTGACGATCTC|TCACGGCGGACAGAACGGCTGCGTATCAAC
TGTCCTATGGCTGCTCTTTGATGGCTACAA|TCTGTAAAACCAACTTGCTGGGTTATACGA
GAAATGGGAAGTGTCCTATGGCTGCTCTTT|GTGCGGGGTCATCTGTAAAACCAACTTGCT
CGTGATGGTGAACACGGCGACTACTGCAAG|TGAGCGTGATTTGTCGATTTACGAATCCCC
CGTAGCTACAACTAATTCGGTTGATCCGAG|CTTGTGCTTTATGTAAAATCCTACAACTAA
CGACTGAGTGTGAAAGATAGTAACCCATTG|CAACTAATTCGGTTGATCCGAGAGGTGGAG
GAGGTGCCTTTAACGGTCTCACCTCCAGAG|GCCCCATTCTGACCCCAGTCACTTGCAGCC
ACTGAGTGTGAAAGATAGTAACCCATTGCG|ACTAATTCGGTTGATCCGAGAGGTGGAGTT
TAGTAACCCATTGCGTCATCTACAACTAAT|CCGAGAGGTGGAGTTCGACTACAACTAATT
CATAGGATCTCGCATGTCAAAGTCTGAGCA|GCGCCTGGATATGGACTGTTAATATCCTCT
GTTGATCCGAGAGGTGATGAAATGGGAAGT|ATTCGGTTGATCCGAGAGGTGCGGGGTCAT
ACCTCCAGAGCCGTCGGATGTAAGTTGAGC|ACTTGCAGCCCAGCGGATGGAATTTATAGC
AGAGGTGGACAAACGGCTGGATTCCAGACC|TAACGTCTCAAGTCCGGCCTCGATACGGAG
TTCGGTTTAGTTCCTACAACTAATTCGGTT|TCCGTCCAGGCTTCGCTTCGCTAGCTACAA
AAGTAAAGCTCCTTAGGGGGGACCCGCTTA|GGATGGCGCTACAACTAATTCGGTTGATCC
CTCGTACCGACTCGTGGTAGGACACATTAA|AACCTGCTCACAGTTCCTACAACTAATTCG
GCGTGATGGTGAACACGGCGACTACTGCAA|TTGAGCGTGATTTGTCGATTTACGAATCCC
CTACAACTAATTCGGTTGATCCGAGAGGTG|CTGTTACGGAACCTTTCCATACAAGCCCCA
TGATCCGAGAGGTGGAATAAGCATCAAAGG|CCTACAACTAATTCGGTTGATCCGAGAGGT
AGCCGTCGGATGTAAGTTGAGCGTGATTTG|CCCAGCGGATGGAATTTATAGCGAGGCGAG
AGGTGTAATTCGGTTGATCCGAGAGGTGCG|GGCTACAACTAATTCGGTTGATCCGAGAGG
CAACCTACAACTAATTCGGTTGATCCGAGA|ACAACTAATTCGGTTGATCCGAGAGGTGAG
GTGACGATCTCAATAATGACGGGCTCTCCC|TGCGTATCAACCCGGTATGAAAGTAAAGCT
CTTTAACGGTCTCACCTCCAGAGCCGTCGG|TCTGACCCCAGTCACTTGCAGCCCAGCGGA
TCCGAGAGGTGCCTTTAACGGTCTCACCTC|TACAAGCCCCATTCTGACCCCAGTCACTTG
TTGTGCTTTATGTAAAATCCTACAACTAAT|ATCTTGTCCTACAACTAATTCGGTTGATCC
AGAGGTGCGGGGTCATCTGTAAAACCAACT|TCCGAGAGGTGACGATCTCAATAATGACGG
TAACTGACGACAACGCCTATAGATAGCGAA|GAGAGGTGATTTAACTCGTACCGACTCGTG
GGTCATCTGTAAAACCAACTTGCTGGGTTA|GACGATCTCAATAATGACGGGCTCTCCCGC
GATGGCTACAACTAATTCGGTTGATCCGAG|GGGTTATACGACTGAGTGTGAAAGATAGTA
TCCTATGGCTGCTCTTTGATGGCTACAACT|TGTAAAACCAACTTGCTGGGTTATACGACT
AGCCCGTGAGATTAGATACCTCCGTCCAGG|TCCGAGAGGTGCAGTACGTCTACAACCTAC
CACGCATCAGGTTGGATGGCGCTACAACTA|GTCATTGCGCCCTATGGCAGACTGTTACGG
TTTAACTCGTACCGACTCGTGGTAGGACAC|AAGGGAACCTGCTCACAGTTCCTACAACTA
TTCAGTACTACAACTAATTCGGTTGATCCG|TCCGAGAGGTGATGAAATGGGAAGTGTCCT
AGCATCAAAGGGAACCTGCTCACAGTTCCT|ATCCGAGAGGTGTTCAGTACTACAACTAAT
CGAGAGGTGATTTAACTCGTACCGACTCGT|ATAAGCATCAAAGGGAACCTGCTCACAGTT
CACATTAACTTTCGCGCCTGGATATGGACT|CTAATTCGGTTGATCCGAGAGGTGGACAAA
TAATTCGGTTGATCCGAGAGGTGATGATAC|TGAGATGGCCGAATTATTGAGCGTGATGGT
TCGGTTGATCCGAGAGGTGGCTAACGTCTC|GGGAAGTGTCCTATGGCTGCTCTTTGATGG
AACGTCTCAAGTCCGGCCTCGATACGGAGC|TTTGATGGCTACAACTAATTCGGTTGATCC
AATATCCTCTTAATGTAATGATCTTGTCCT|CTGGATTCCAGACCAAGGGCCCCCGACATC
TAAGCATCAAAGGGAACCTGCTCACAGTTC|TGATCCGAGAGGTGTTCAGTACTACAACTA
ACACGGCGACTACTGCAAGCCTCCTCGCAC|TGTCGATTTACGAATCCCCCGGGTCCATTG
GGGCCCCCGACATCAATTCGGTTTAGTTCC|CGTGAGATTAGATACCTCCGTCCAGGCTTC
AGATGGCCGAATTATTGAGCGTGATGGTGA|AGAGCCGTCGGATGTAAGTTGAGCGTGATT
CGGCGGACAGAACGGCTGCGTATCAACCCG|CGACTACTGCAAGCCTCCTCGCACACGCAT
CCTACAACTAATTCGGTTGATCCGAGAGGT|TTCGGTTGATCCGAGAGGTGGAATAAGCAT
CGAGAGGTGTAATTCGGTTGATCCGAGAGG|GTGAGGCTACAACTAATTCGGTTGATCCGA
GTCCATTGTCATTGCGCCCTATGGCAGACT|CGATTCCCGAAGTACAAGATGAACCGTCAA
CTACTGCAAGCCTCCTCGCACACGCATCAG|ACGAATCCCCCGGGTCCATTGTCATTGCGC
CCGAGAGGTGGACAAACGGCTGGATTCCAG|GGCTAACGTCTCAAGTCCGGCCTCGATACG
CTAATTCGGTTGATCCGAGAGGTGACGATC|ACTCACGGCGGACAGAACGGCTGCGTATCA
TGCTGGGTTATACGACTGAGTGTGAAAGAT|GCTCTCCCGCTACAACTAATTCGGTTGATC
GCGAAGCCATCGCCTTCGTCCGCGCATAGG|TCGTGGTAGGACACATTAACTTTCGCGCCT
ACGCGACTCACGGCGGACAGAACGGCTGCG|GTGAACACGGCGACTACTGCAAGCCTCCTC
TGATCCGAGAGGTGGCTAACGTCTCAAGTC|GTGTCCTATGGCTGCTCTTTGATGGCTACA
ACTAATTCGGTTGATCCGAGAGGTGTTGTT|ATGTAAAATCCTACAACTAATTCGGTTGAT
GAATAAGCATCAAAGGGAACCTGCTCACAG|GGTTGATCCGAGAGGTGTTCAGTACTACAA
TTATACGACTGAGTGTGAAAGATAGTAACC|CGCTACAACTAATTCGGTTGATCCGAGAGG
CGAGAGGTGGAATAAGCATCAAAGGGAACC|AACTAATTCGGTTGATCCGAGAGGTGTTCA
CGAGAGGTGTTGTTATTAACTGACGACAAC|CTAATTCGGTTGATCCGAGAGGTGATTTAA
TCCGAGAGGTGGAGTTCGACTACAACTAAT|TGCAAACAGGGATTTTCCGCATCTCTTGAG
TATGCAAACAGGGATTTTCCGCATCTCTTG|CCGAGAGGTGCCTTTAACGGTCTCACCTCC
GACGGGCTCTCCCGCTACAACTAATTCGGT|TGAAAGTAAAGCTCCTTAGGGGGGACCCGC
CAAGTCCGGCCTCGATACGGAGCCCGTGAG|GCTACAACTAATTCGGTTGATCCGAGAGGT
GCCCGTGAGATTAGATACCTCCGTCCAGGC|CCGAGAGGTGCAGTACGTCTACAACCTACA
TGTGAAAGATAGTAACCCATTGCGTCATCT|TCGGTTGATCCGAGAGGTGGAGTTCGACTA
TTCCTTGTGCTTTATGTAAAATCCTACAAC|AATGATCTTGTCCTACAACTAATTCGGTTG
GTGTAATTCGGTTGATCCGAGAGGTGCGGG|CTACAACTAATTCGGTTGATCCGAGAGGTG
AACTGACGACAACGCCTATAGATAGCGAAG|AGAGGTGATTTAACTCGTACCGACTCGTGG
TCAGTACTACAACTAATTCGGTTGATCCGA|CCGAGAGGTGATGAAATGGGAAGTGTCCTA
CGGTTGATCCGAGAGGTGTAATTCGGTTGA|ATCCGAGAGGTGAGGCTACAACTAATTCGG
GGTGAACACGGCGACTACTGCAAGCCTCCT|TGATTTGTCGATTTACGAATCCCCCGGGTC
TGATCCGAGAGGTGATTTAACTCGTACCGA|GTGGAATAAGCATCAAAGGGAACCTGCTCA
GGCTGCGTATCAACCCGGTATGAAAGTAAA|CCTCCTCGCACACGCATCAGGTTGGATGGC
CTAATTCGGTTGATCCGAGAGGTGATGATA|TTGAGATGGCCGAATTATTGAGCGTGATGG
ACAACTAATTCGGTTGATCCGAGAGGTGAT|TCTCTTGAGATGGCCGAATTATTGAGCGTG
ATTCGGTTGATCCGAGAGGTGGCTAACGTC|ATGGGAAGTGTCCTATGGCTGCTCTTTGAT
ACAACTAATTCGGTTGATCCGAGAGGTGTA|AATTCGGTTGATCCGAGAGGTGAGGCTACA
AAGCCATCGCCTTCGTCCGCGCATAGGATC|TGGTAGGACACATTAACTTTCGCGCCTGGA
TCGCTAGCTACAACTAATTCGGTTGATCCG|TCGGTTGATCCGAGAGGTGTAATTCGGTTG
GGAACCTGCTCACAGTTCCTACAACTAATT|TGTTCAGTACTACAACTAATTCGGTTGATC
CAGTACGTCTACAACCTACAACTAATTCGG|TTGCGTCATCTACAACTAATTCGGTTGATC
GCCTTTAACGGTCTCACCTCCAGAGCCGTC|ATTCTGACCCCAGTCACTTGCAGCCCAGCG
AGGTGTTGTTATTAACTGACGACAACGCCT|TTCGGTTGATCCGAGAGGTGATTTAACTCG
TTCACGTAGCTACAACTAATTCGGTTGATC|CTTCCTTGTGCTTTATGTAAAATCCTACAA
GCGTGATTTGTCGATTTACGAATCCCCCGG|GCGAGGCGAGGACCCACCCGCATGTCTAGA
AGCTCCTTAGGGGGGACCCGCTTATGCAAA|CGCTACAACTAATTCGGTTGATCCGAGAGG
AGAGGTGTTGTTATTAACTGACGACAACGC|AATTCGGTTGATCCGAGAGGTGATTTAACT
CGGTCTCACCTCCAGAGCCGTCGGATGTAA|CCCAGTCACTTGCAGCCCAGCGGATGGAAT
TTAACTGACGACAACGCCTATAGATAGCGA|CGAGAGGTGATTTAACTCGTACCGACTCGT
CCGAGAGGTGAGGCTACAACTAATTCGGTT|CGAGAGGTGATGATACGCGACTCACGGCGG
GCTCACAGTTCCTACAACTAATTCGGTTGA|TACTACAACTAATTCGGTTGATCCGAGAGG
TTGTCCTACAACTAATTCGGTTGATCCGAG|CGACATCAATTCGGTTTAGTTCCTACAACT
TCTTTGATGGCTACAACTAATTCGGTTGAT|TTGCTGGGTTATACGACTGAGTGTGAAAGA
CGTCTCAAGTCCGGCCTCGATACGGAGCCC|TGATGGCTACAACTAATTCGGTTGATCCGA
GGATCTCGCATGTCAAAGTCTGAGCACATC|CTGGATATGGACTGTTAATATCCTCTTAAT
GATCCGAGAGGTGGAATAAGCATCAAAGGG|CTACAACTAATTCGGTTGATCCGAGAGGTG
TTAACTCGTACCGACTCGTGGTAGGACACA|AGGGAACCTGCTCACAGTTCCTACAACTAA
AAATGGGAAGTGTCCTATGGCTGCTCTTTG|TGCGGGGTCATCTGTAAAACCAACTTGCTG
GCGCTACAACTAATTCGGTTGATCCGAGAG|AGACTGTTACGGAACCTTTCCATACAAGCC
CGAATTATTGAGCGTGATGGTGAACACGGC|TCGGATGTAAGTTGAGCGTGATTTGTCGAT
TGTTGTTATTAACTGACGACAACGCCTATA|GGTTGATCCGAGAGGTGATTTAACTCGTAC
CTGCGTATCAACCCGGTATGAAAGTAAAGC|TCCTCGCACACGCATCAGGTTGGATGGCGC
GGGTCATCTGTAAAACCAACTTGCTGGGTT|TGACGATCTCAATAATGACGGGCTCTCCCG
AATTCGGTTGATCCGAGAGGTGGAATAAGC|GTTTAGTTCCTACAACTAATTCGGTTGATC
ATGACGGGCTCTCCCGCTACAACTAATTCG|TATGAAAGTAAAGCTCCTTAGGGGGGACCC
ACTTATTCACGTAGCTACAACTAATTCGGT|CATCTCTTCCTTGTGCTTTATGTAAAATCC
CGGGCTCTCCCGCTACAACTAATTCGGTTG|AAAGTAAAGCTCCTTAGGGGGGACCCGCTT
AGGTGGCTAACGTCTCAAGTCCGGCCTCGA|GGCTGCTCTTTGATGGCTACAACTAATTCG
ACAGTTCCTACAACTAATTCGGTTGATCCG|ACAACTAATTCGGTTGATCCGAGAGGTGGC
ACGGCGACTACTGCAAGCCTCCTCGCACAC|TCGATTTACGAATCCCCCGGGTCCATTGTC
ATCAACCCGGTATGAAAGTAAAGCTCCTTA|CACACGCATCAGGTTGGATGGCGCTACAAC
TCGTACCGACTCGTGGTAGGACACATTAAC|ACCTGCTCACAGTTCCTACAACTAATTCGG
CAACTAATTCGGTTGATCCGAGAGGTGATG|CGAGAGGTGTAATTCGGTTGATCCGAGAGG
CAAACAGGGATTTTCCGCATCTCTTGAGAT|GAGGTGCCTTTAACGGTCTCACCTCCAGAG
CGCATCTCTTGAGATGGCCGAATTATTGAG|GTCTCACCTCCAGAGCCGTCGGATGTAAGT
GGCCCCCGACATCAATTCGGTTTAGTTCCT|GTGAGATTAGATACCTCCGTCCAGGCTTCG
CGAGAGGTGGAGTTCGACTACAACTAATTC|CAAACAGGGATTTTCCGCATCTCTTGAGAT
TTTCGCGCCTGGATATGGACTGTTAATATC|TTGATCCGAGAGGTGGACAAACGGCTGGAT
TTCGGTTGATCCGAGAGGTGATGAAATGGG|TGTAATTCGGTTGATCCGAGAGGTGCGGGG
AGAGGTGTTCAGTACTACAACTAATTCGGT|CGGTTGATCCGAGAGGTGATGAAATGGGAA
GGACTGTTAATATCCTCTTAATGTAATGAT|ACAAACGGCTGGATTCCAGACCAAGGGCCC
AACTAATTCGGTTGATCCGAGAGGTGATGA|GAGAGGTGTAATTCGGTTGATCCGAGAGGT
AACTTGCTGGGTTATACGACTGAGTGTGAA|ACGGGCTCTCCCGCTACAACTAATTCGGTT
ATTCGGTTGATCCGAGAGGTGACGATCTCA|CACGGCGGACAGAACGGCTGCGTATCAACC
TAACGGTCTCACCTCCAGAGCCGTCGGATG|GACCCCAGTCACTTGCAGCCCAGCGGATGG
GGTTGATCCGAGAGGTGCCTTTAACGGTCT|TTTCCATACAAGCCCCATTCTGACCCCAGT
TTCGCGCCTGGATATGGACTGTTAATATCC|TGATCCGAGAGGTGGACAAACGGCTGGATT
CGACATCAATTCGGTTTAGTTCCTACAACT|TTAGATACCTCCGTCCAGGCTTCGCTTCGC
GGCGACTACTGCAAGCCTCCTCGCACACGC|GATTTACGAATCCCCCGGGTCCATTGTCAT
TTAGGGGGGACCCGCTTATGCAAACAGGGA|AACTAATTCGGTTGATCCGAGAGGTGCCTT
TAAAGCTCCTTAGGGGGGACCCGCTTATGC|TGGCGCTACAACTAATTCGGTTGATCCGAG
CTATAGATAGCGAAGCCATCGCCTTCGTCC|CGTACCGACTCGTGGTAGGACACATTAACT
TACGACTGAGTGTGAAAGATAGTAACCCAT|TACAACTAATTCGGTTGATCCGAGAGGTGG
AGACCAAGGGCCCCCGACATCAATTCGGTT|CGGAGCCCGTGAGATTAGATACCTCCGTCC
CTAATTCGGTTGATCCGAGAGGTGGACAAA|TTGATCCGAGAGGTGGCTAACGTCTCAAGT
AGGTGATGAAATGGGAAGTGTCCTATGGCT|CCGAGAGGTGCGGGGTCATCTGTAAAACCA
GGGTTATACGACTGAGTGTGAAAGATAGTA|TCCCGCTACAACTAATTCGGTTGATCCGAG
TGAGGCTACAACTAATTCGGTTGATCCGAG|GATGATACGCGACTCACGGCGGACAGAACG
CGGTTGATCCGAGAGGTGGCTAACGTCTCA|GGAAGTGTCCTATGGCTGCTCTTTGATGGC
TCATTGCGCCCTATGGCAGACTGTTACGGA|GAAGTACAAGATGAACCGTCAAGGACTAGA
CGGTTGATCCGAGAGGTGGACAAACGGCTG|CGAGAGGTGGCTAACGTCTCAAGTCCGGCC
CTCCGTCCAGGCTTCGCTTCGCTAGCTACA|CTACAACCTACAACTAATTCGGTTGATCCG
TCAAAGGGAACCTGCTCACAGTTCCTACAA|GAGAGGTGTTCAGTACTACAACTAATTCGG
GAACGGCTGCGTATCAACCCGGTATGAAAG|CAAGCCTCCTCGCACACGCATCAGGTTGGA
ACGGAGCCCGTGAGATTAGATACCTCCGTC|TTGATCCGAGAGGTGCAGTACGTCTACAAC
CTCTTTGATGGCTACAACTAATTCGGTTGA|CTTGCTGGGTTATACGACTGAGTGTGAAAG
GGGAAGTGTCCTATGGCTGCTCTTTGATGG|GGGTCATCTGTAAAACCAACTTGCTGGGTT
TGTAAGTTGAGCGTGATTTGTCGATTTACG|GGAATTTATAGCGAGGCGAGGACCCACCCG
CTACAACTAATTCGGTTGATCCGAGAGGTG|ATCCGAGAGGTGTAATTCGGTTGATCCGAG
GATCCGAGAGGTGAGGCTACAACTAATTCG|ATCCGAGAGGTGATGATACGCGACTCACGG
CCGTGAGATTAGATACCTCCGTCCAGGCTT|GAGAGGTGCAGTACGTCTACAACCTACAAC
TTGATCCGAGAGGTGATTTAACTCGTACCG|GGTGGAATAAGCATCAAAGGGAACCTGCTC
GTGGAGTTCGACTACAACTAATTCGGTTGA|GGGATTTTCCGCATCTCTTGAGATGGCCGA
AGCTACAACTAATTCGGTTGATCCGAGAGG|GTGCTTTATGTAAAATCCTACAACTAATTC
CTCCTTAGGGGGGACCCGCTTATGCAAACA|CTACAACTAATTCGGTTGATCCGAGAGGTG
CTCGCACACGCATCAGGTTGGATGGCGCTA|TCCATTGTCATTGCGCCCTATGGCAGACTG
ATTCGGTTGATCCGAGAGGTGCGGGGTCAT|ACTAATTCGGTTGATCCGAGAGGTGACGAT
AACTAATTCGGTTGATCCGAGAGGTGGAAT|TTCGGTTTAGTTCCTACAACTAATTCGGTT
ATTCGGTTGATCCGAGAGGTGGAGTTCGAC|GACCCGCTTATGCAAACAGGGATTTTCCGC
ACGCCTATAGATAGCGAAGCCATCGCCTTC|AACTCGTACCGACTCGTGGTAGGACACATT
CTAACGTCTCAAGTCCGGCCTCGATACGGA|TCTTTGATGGCTACAACTAATTCGGTTGAT
ATTAACTGACGACAACGCCTATAGATAGCG|CCGAGAGGTGATTTAACTCGTACCGACTCG
CAACTAATTCGGTTGATCCGAGAGGTGTAA|ATTCGGTTGATCCGAGAGGTGAGGCTACAA
AAACAGGGATTTTCCGCATCTCTTGAGATG|AGGTGCCTTTAACGGTCTCACCTCCAGAGC
ATCCGAGAGGTGAGGCTACAACTAATTCGG|TCCGAGAGGTGATGATACGCGACTCACGGC
CCTACAACTAATTCGGTTGATCCGAGAGGT|ATCAATTCGGTTTAGTTCCTACAACTAATT
ATGTAATGATCTTGTCCTACAACTAATTCG|CCAAGGGCCCCCGACATCAATTCGGTTTAG
CCCCCGGGTCCATTGTCATTGCGCCCTATG|GTCTAGACGATTCCCGAAGTACAAGATGAA
GAACACGGCGACTACTGCAAGCCTCCTCGC|TTTGTCGATTTACGAATCCCCCGGGTCCAT
TCCTACAACTAATTCGGTTGATCCGAGAGG|CATCAATTCGGTTTAGTTCCTACAACTAAT
TACAACTAATTCGGTTGATCCGAGAGGTGG|CAATTCGGTTTAGTTCCTACAACTAATTCG
ATGGCAGACTGTTACGGAACCTTTCCATAC|GAACCGTCAAGGACTAGATCTCGCTTCCAC
AAGGGAACCTGCTCACAGTTCCTACAACTA|AGGTGTTCAGTACTACAACTAATTCGGTTG
TCAGGTTGGATGGCGCTACAACTAATTCGG|GCGCCCTATGGCAGACTGTTACGGAACCTT
TAATTCGGTTGATCCGAGAGGTGATTTAAC|ATCCGAGAGGTGGAATAAGCATCAAAGGGA
GACATCAATTCGGTTTAGTTCCTACAACTA|TAGATACCTCCGTCCAGGCTTCGCTTCGCT
ACTAATTCGGTTGATCCGAGAGGTGCCTTT|ACGGAACCTTTCCATACAAGCCCCATTCTG
AAAGTCTGAGCACATCTCTTCCTTGTGCTT|TTAATATCCTCTTAATGTAATGATCTTGTC
ACTAATTCGGTTGATCCGAGAGGTGAGGCT|CTAATTCGGTTGATCCGAGAGGTGATGATA
CCGAGAGGTGCGGGGTCATCTGTAAAACCA|TGATCCGAGAGGTGACGATCTCAATAATGA
CCGAGAGGTGATTTAACTCGTACCGACTCG|AATAAGCATCAAAGGGAACCTGCTCACAGT
GGTCTACTTATTCACGTAGCTACAACTAAT|GAGCACATCTCTTCCTTGTGCTTTATGTAA
GCATAGGATCTCGCATGTCAAAGTCTGAGC|CGCGCCTGGATATGGACTGTTAATATCCTC
TACAACTAATTCGGTTGATCCGAGAGGTGA|CGGTTGATCCGAGAGGTGGAATAAGCATCA
TAATTCGGTTGATCCGAGAGGTGTTCAGTA|CTAGCTACAACTAATTCGGTTGATCCGAGA
TTGATCCGAGAGGTGTTGTTATTAACTGAC|CTACAACTAATTCGGTTGATCCGAGAGGTG
GGTTGATCCGAGAGGTGATGATACGCGACT|GGCCGAATTATTGAGCGTGATGGTGAACAC
CGCCTATAGATAGCGAAGCCATCGCCTTCG|ACTCGTACCGACTCGTGGTAGGACACATTA
ATCAAAGGGAACCTGCTCACAGTTCCTACA|CGAGAGGTGTTCAGTACTACAACTAATTCG
GCTTCGCTAGCTACAACTAATTCGGTTGAT|AATTCGGTTGATCCGAGAGGTGTAATTCGG
GGCTTCGCTTCGCTAGCTACAACTAATTCG|ACAACTAATTCGGTTGATCCGAGAGGTGTA
TTGAGCGTGATTTGTCGATTTACGAATCCC|TATAGCGAGGCGAGGACCCACCCGCATGTC
CTCCTCGCACACGCATCAGGTTGGATGGCG|GGGTCCATTGTCATTGCGCCCTATGGCAGA
GACAGAACGGCTGCGTATCAACCCGGTATG|ACTGCAAGCCTCCTCGCACACGCATCAGGT
CAGGCTTCGCTTCGCTAGCTACAACTAATT|CTACAACTAATTCGGTTGATCCGAGAGGTG
TACAACTAATTCGGTTGATCCGAGAGGTGG|GTGATGAAATGGGAAGTGTCCTATGGCTGC
ATGGCCGAATTATTGAGCGTGATGGTGAAC|AGCCGTCGGATGTAAGTTGAGCGTGATTTG
TGACGACAACGCCTATAGATAGCGAAGCCA|GGTGATTTAACTCGTACCGACTCGTGGTAG
CCCGCTACAACTAATTCGGTTGATCCGAGA|GCTCCTTAGGGGGGACCCGCTTATGCAAAC
GCCTCGATACGGAGCCCGTGAGATTAGATA|TAATTCGGTTGATCCGAGAGGTGCAGTACG
AGAGGTGCAGTACGTCTACAACCTACAACT|TAACCCATTGCGTCATCTACAACTAATTCG
CTCAAGTCCGGCCTCGATACGGAGCCCGTG|TGGCTACAACTAATTCGGTTGATCCGAGAG
TGATCCGAGAGGTGTTCAGTACTACAACTA|ACTAATTCGGTTGATCCGAGAGGTGATGAA
TCTGTAAAACCAACTTGCTGGGTTATACGA|TCTCAATAATGACGGGCTCTCCCGCTACAA
AGGTGCGGGGTCATCTGTAAAACCAACTTG|CGAGAGGTGACGATCTCAATAATGACGGGC
AGGATCTCGCATGTCAAAGTCTGAGCACAT|CCTGGATATGGACTGTTAATATCCTCTTAA
GTGATTTAACTCGTACCGACTCGTGGTAGG|ATCAAAGGGAACCTGCTCACAGTTCCTACA
ACTTTCGCGCCTGGATATGGACTGTTAATA|GGTTGATCCGAGAGGTGGACAAACGGCTGG
TACAACTAATTCGGTTGATCCGAGAGGTGC|TGTTACGGAACCTTTCCATACAAGCCCCAT
TCGGTTTAGTTCCTACAACTAATTCGGTTG|CCGTCCAGGCTTCGCTTCGCTAGCTACAAC
TAAAATCCTACAACTAATTCGGTTGATCCG|AACTAATTCGGTTGATCCGAGAGGTGGAAT
TGCGTCATCTACAACTAATTCGGTTGATCC|AGTTCGACTACAACTAATTCGGTTGATCCG
AATAAGCATCAAAGGGAACCTGCTCACAGT|GTTGATCCGAGAGGTGTTCAGTACTACAAC
CAGTTCCTACAACTAATTCGGTTGATCCGA|CAACTAATTCGGTTGATCCGAGAGGTGGCT
TACCGACTCGTGGTAGGACACATTAACTTT|TGCTCACAGTTCCTACAACTAATTCGGTTG
GGCCTCGATACGGAGCCCGTGAGATTAGAT|CTAATTCGGTTGATCCGAGAGGTGCAGTAC
ATATCCTCTTAATGTAATGATCTTGTCCTA|TGGATTCCAGACCAAGGGCCCCCGACATCA
TTCGGTTGATCCGAGAGGTGCAGTACGTCT|GTGTGAAAGATAGTAACCCATTGCGTCATC
AGGGATTTTCCGCATCTCTTGAGATGGCCG|GCCTTTAACGGTCTCACCTCCAGAGCCGTC
TAGGACACATTAACTTTCGCGCCTGGATAT|TACAACTAATTCGGTTGATCCGAGAGGTGG
TGCTCACAGTTCCTACAACTAATTCGGTTG|GTACTACAACTAATTCGGTTGATCCGAGAG
AGCGAAGCCATCGCCTTCGTCCGCGCATAG|CTCGTGGTAGGACACATTAACTTTCGCGCC
GCAAACAGGGATTTTCCGCATCTCTTGAGA|AGAGGTGCCTTTAACGGTCTCACCTCCAGA
ATCTGTAAAACCAACTTGCTGGGTTATACG|ATCTCAATAATGACGGGCTCTCCCGCTACA
CAACTAATTCGGTTGATCCGAGAGGTGGAG|AGGGGGGACCCGCTTATGCAAACAGGGATT
GGGGTCATCTGTAAAACCAACTTGCTGGGT|GTGACGATCTCAATAATGACGGGCTCTCCC
GGCAGACTGTTACGGAACCTTTCCATACAA|ACCGTCAAGGACTAGATCTCGCTTCCACCA
ACCAACTTGCTGGGTTATACGACTGAGTGT|ATGACGGGCTCTCCCGCTACAACTAATTCG
CCGAGAGGTGATGAAATGGGAAGTGTCCTA|TTGATCCGAGAGGTGCGGGGTCATCTGTAA
GGGAACCTGCTCACAGTTCCTACAACTAAT|GTGTTCAGTACTACAACTAATTCGGTTGAT
TATCAACCCGGTATGAAAGTAAAGCTCCTT|GCACACGCATCAGGTTGGATGGCGCTACAA
AACACGGCGACTACTGCAAGCCTCCTCGCA|TTGTCGATTTACGAATCCCCCGGGTCCATT
AAATCCTACAACTAATTCGGTTGATCCGAG|CTAATTCGGTTGATCCGAGAGGTGGAATAA
CAATTCGGTTTAGTTCCTACAACTAATTCG|ACCTCCGTCCAGGCTTCGCTTCGCTAGCTA
GCATCAGGTTGGATGGCGCTACAACTAATT|ATTGCGCCCTATGGCAGACTGTTACGGAAC
CTACAACTAATTCGGTTGATCCGAGAGGTG|CTAATTCGGTTGATCCGAGAGGTGAGGCTA
GCTACAACTAATTCGGTTGATCCGAGAGGT|GATCCGAGAGGTGTAATTCGGTTGATCCGA
CCAGACCAAGGGCCCCCGACATCAATTCGG|TACGGAGCCCGTGAGATTAGATACCTCCGT
TTCGGTTGATCCGAGAGGTGCCTTTAACGG|ACCTTTCCATACAAGCCCCATTCTGACCCC
TGGTGAACACGGCGACTACTGCAAGCCTCC|GTGATTTGTCGATTTACGAATCCCCCGGGT
GTTGATCCGAGAGGTGGAGTTCGACTACAA|GCTTATGCAAACAGGGATTTTCCGCATCTC
CAACTAATTCGGTTGATCCGAGAGGTGGCT|GATGAAATGGGAAGTGTCCTATGGCTGCTC
AACTCGTACCGACTCGTGGTAGGACACATT|GGAACCTGCTCACAGTTCCTACAACTAATT
AGGTGAGGCTACAACTAATTCGGTTGATCC|GGTGATGATACGCGACTCACGGCGGACAGA
CGGGTCCATTGTCATTGCGCCCTATGGCAG|AGACGATTCCCGAAGTACAAGATGAACCGT
TCTTGTCCTACAACTAATTCGGTTGATCCG|CCCGACATCAATTCGGTTTAGTTCCTACAA
AACTAATTCGGTTGATCCGAGAGGTGTTGT|TATGTAAAATCCTACAACTAATTCGGTTGA
ACATCTCTTCCTTGTGCTTTATGTAAAATC|TTAATGTAATGATCTTGTCCTACAACTAAT
TATAGATAGCGAAGCCATCGCCTTCGTCCG|GTACCGACTCGTGGTAGGACACATTAACTT
GTGCTTTATGTAAAATCCTACAACTAATTC|CTTGTCCTACAACTAATTCGGTTGATCCGA
TAATGATCTTGTCCTACAACTAATTCGGTT|AGGGCCCCCGACATCAATTCGGTTTAGTTC
ATCCGAGAGGTGATTTAACTCGTACCGACT|GGAATAAGCATCAAAGGGAACCTGCTCACA
GAGAGGTGCAGTACGTCTACAACCTACAAC|GTAACCCATTGCGTCATCTACAACTAATTC
CCTGGATATGGACTGTTAATATCCTCTTAA|GAGAGGTGGACAAACGGCTGGATTCCAGAC
CTACAACTAATTCGGTTGATCCGAGAGGTG|GCTTTATGTAAAATCCTACAACTAATTCGG
TCACAGTTCCTACAACTAATTCGGTTGATC|CTACAACTAATTCGGTTGATCCGAGAGGTG
ACCAAGGGCCCCCGACATCAATTCGGTTTA|GAGCCCGTGAGATTAGATACCTCCGTCCAG
TGTTAATATCCTCTTAATGTAATGATCTTG|ACGGCTGGATTCCAGACCAAGGGCCCCCGA
AAGCTCCTTAGGGGGGACCCGCTTATGCAA|GCGCTACAACTAATTCGGTTGATCCGAGAG
AACGGTCTCACCTCCAGAGCCGTCGGATGT|ACCCCAGTCACTTGCAGCCCAGCGGATGGA
GATGGCGCTACAACTAATTCGGTTGATCCG|TGGCAGACTGTTACGGAACCTTTCCATACA
AGGACACATTAACTTTCGCGCCTGGATATG|ACAACTAATTCGGTTGATCCGAGAGGTGGA
CCAACTTGCTGGGTTATACGACTGAGTGTG|TGACGGGCTCTCCCGCTACAACTAATTCGG
TCAACCCGGTATGAAAGTAAAGCTCCTTAG|ACACGCATCAGGTTGGATGGCGCTACAACT
CCGAGAGGTGGCTAACGTCTCAAGTCCGGC|CCTATGGCTGCTCTTTGATGGCTACAACTA
CATTAACTTTCGCGCCTGGATATGGACTGT|AATTCGGTTGATCCGAGAGGTGGACAAACG
TAATTCGGTTGATCCGAGAGGTGCGGGGTC|CAACTAATTCGGTTGATCCGAGAGGTGACG
ATTCGGTTGATCCGAGAGGTGTTGTTATTA|AAAATCCTACAACTAATTCGGTTGATCCGA
TCCGAGAGGTGATGAAATGGGAAGTGTCCT|GTTGATCCGAGAGGTGCGGGGTCATCTGTA
CTACTTATTCACGTAGCTACAACTAATTCG|CACATCTCTTCCTTGTGCTTTATGTAAAAT
GCTTCGCTTCGCTAGCTACAACTAATTCGG|CAACTAATTCGGTTGATCCGAGAGGTGTAA
CATCTACAACTAATTCGGTTGATCCGAGAG|GACTACAACTAATTCGGTTGATCCGAGAGG
AATTCGGTTGATCCGAGAGGTGGAGTTCGA|GGACCCGCTTATGCAAACAGGGATTTTCCG
TAGCTACAACTAATTCGGTTGATCCGAGAG|TTGATCCGAGAGGTGTAATTCGGTTGATCC
ACGGGCTCTCCCGCTACAACTAATTCGGTT|GAAAGTAAAGCTCCTTAGGGGGGACCCGCT
TTGTCGATTTACGAATCCCCCGGGTCCATT|GAGGACCCACCCGCATGTCTAGACGATTCC
GTGCGGGGTCATCTGTAAAACCAACTTGCT|AGAGGTGACGATCTCAATAATGACGGGCTC
TAATTCGGTTGATCCGAGAGGTGATGAAAT|AGGTGTAATTCGGTTGATCCGAGAGGTGCG
AAAGCTCCTTAGGGGGGACCCGCTTATGCA|GGCGCTACAACTAATTCGGTTGATCCGAGA
ATCCGAGAGGTGGAGTTCGACTACAACTAA|ATGCAAACAGGGATTTTCCGCATCTCTTGA
ATCCGAGAGGTGTAATTCGGTTGATCCGAG|GAGGTGAGGCTACAACTAATTCGGTTGATC
CAACTAATTCGGTTGATCCGAGAGGTGAGG|AACTAATTCGGTTGATCCGAGAGGTGATGA
TACAACCTACAACTAATTCGGTTGATCCGA|CTACAACTAATTCGGTTGATCCGAGAGGTG
TAATTCGGTTGATCCGAGAGGTGTAATTCG|GGTTGATCCGAGAGGTGAGGCTACAACTAA
CACCTCCAGAGCCGTCGGATGTAAGTTGAG|CACTTGCAGCCCAGCGGATGGAATTTATAG
CGACTACTGCAAGCCTCCTCGCACACGCAT|TTTACGAATCCCCCGGGTCCATTGTCATTG
ACAACTAATTCGGTTGATCCGAGAGGTGGA|TCGGTTGATCCGAGAGGTGGCTAACGTCTC
TTGATCCGAGAGGTGATGATACGCGACTCA|CCGAATTATTGAGCGTGATGGTGAACACGG
GAGGTGATGAAATGGGAAGTGTCCTATGGC|TCCGAGAGGTGCGGGGTCATCTGTAAAACC
GGTTGGATGGCGCTACAACTAATTCGGTTG|CCCTATGGCAGACTGTTACGGAACCTTTCC
GTCTCAAGTCCGGCCTCGATACGGAGCCCG|GATGGCTACAACTAATTCGGTTGATCCGAG
TGGACTGTTAATATCCTCTTAATGTAATGA|GACAAACGGCTGGATTCCAGACCAAGGGCC
GAGAGGTGGAGTTCGACTACAACTAATTCG|AAACAGGGATTTTCCGCATCTCTTGAGATG
GAGTTCGACTACAACTAATTCGGTTGATCC|ATTTTCCGCATCTCTTGAGATGGCCGAATT
GGGATTTTCCGCATCTCTTGAGATGGCCGA|CCTTTAACGGTCTCACCTCCAGAGCCGTCG
GTTGATCCGAGAGGTGCAGTACGTCTACAA|GAAAGATAGTAACCCATTGCGTCATCTACA
CGGTTGATCCGAGAGGTGGAATAAGCATCA|AGTTCCTACAACTAATTCGGTTGATCCGAG
CGCATGTCAAAGTCTGAGCACATCTCTTCC|ATGGACTGTTAATATCCTCTTAATGTAATG
AGGCTTCGCTTCGCTAGCTACAACTAATTC|TACAACTAATTCGGTTGATCCGAGAGGTGT
TAATTCGGTTGATCCGAGAGGTGGCTAACG|AAATGGGAAGTGTCCTATGGCTGCTCTTTG
GGTTGATCCGAGAGGTGGAATAAGCATCAA|GTTCCTACAACTAATTCGGTTGATCCGAGA
CTGAGTGTGAAAGATAGTAACCCATTGCGT|CTAATTCGGTTGATCCGAGAGGTGGAGTTC
CTCAATAATGACGGGCTCTCCCGCTACAAC|AACCCGGTATGAAAGTAAAGCTCCTTAGGG
ATAGTAACCCATTGCGTCATCTACAACTAA|TCCGAGAGGTGGAGTTCGACTACAACTAAT
AGTTGAGCGTGATTTGTCGATTTACGAATC|TTTATAGCGAGGCGAGGACCCACCCGCATG
GTGGACAAACGGCTGGATTCCAGACCAAGG|GTCTCAAGTCCGGCCTCGATACGGAGCCCG
TACAACTAATTCGGTTGATCCGAGAGGTGG|TTCGGTTGATCCGAGAGGTGGCTAACGTCT
CAGACCAAGGGCCCCCGACATCAATTCGGT|ACGGAGCCCGTGAGATTAGATACCTCCGTC
TACAACTAATTCGGTTGATCCGAGAGGTGT|CTTTATGTAAAATCCTACAACTAATTCGGT
TCGGTTGATCCGAGAGGTGCGGGGTCATCT|TAATTCGGTTGATCCGAGAGGTGACGATCT
AGATACCTCCGTCCAGGCTTCGCTTCGCTA|GTACGTCTACAACCTACAACTAATTCGGTT
ACAACTAATTCGGTTGATCCGAGAGGTGAT|CCGAGAGGTGTAATTCGGTTGATCCGAGAG
TGGGAAGTGTCCTATGGCTGCTCTTTGATG|GGGGTCATCTGTAAAACCAACTTGCTGGGT
TGATGAAATGGGAAGTGTCCTATGGCTGCT|AGAGGTGCGGGGTCATCTGTAAAACCAACT
GATCCGAGAGGTGCAGTACGTCTACAACCT|AGATAGTAACCCATTGCGTCATCTACAACT
GATATGGACTGTTAATATCCTCTTAATGTA|GGTGGACAAACGGCTGGATTCCAGACCAAG
ACTCGTACCGACTCGTGGTAGGACACATTA|GAACCTGCTCACAGTTCCTACAACTAATTC
CCGGGTCCATTGTCATTGCGCCCTATGGCA|TAGACGATTCCCGAAGTACAAGATGAACCG
AGAGGTGGAATAAGCATCAAAGGGAACCTG|CTAATTCGGTTGATCCGAGAGGTGTTCAGT
ACTACAACTAATTCGGTTGATCCGAGAGGT|GCATCTCTTGAGATGGCCGAATTATTGAGC
CCAGGCTTCGCTTCGCTAGCTACAACTAAT|CCTACAACTAATTCGGTTGATCCGAGAGGT
TACGCGACTCACGGCGGACAGAACGGCTGC|GGTGAACACGGCGACTACTGCAAGCCTCCT
AACGGCTGCGTATCAACCCGGTATGAAAGT|AAGCCTCCTCGCACACGCATCAGGTTGGAT
GTGGAATAAGCATCAAAGGGAACCTGCTCA|TTCGGTTGATCCGAGAGGTGTTCAGTACTA
TCATCTACAACTAATTCGGTTGATCCGAGA|CGACTACAACTAATTCGGTTGATCCGAGAG
TGCGCCCTATGGCAGACTGTTACGGAACCT|TACAAGATGAACCGTCAAGGACTAGATCTC
ACGACTGAGTGTGAAAGATAGTAACCCATT|ACAACTAATTCGGTTGATCCGAGAGGTGGA
AGTACGTCTACAACCTACAACTAATTCGGT|TGCGTCATCTACAACTAATTCGGTTGATCC
AATTCGGTTGATCCGAGAGGTGTAATTCGG|GTTGATCCGAGAGGTGAGGCTACAACTAAT
TGATCCGAGAGGTGAGGCTACAACTAATTC|GATCCGAGAGGTGATGATACGCGACTCACG
GTGAACACGGCGACTACTGCAAGCCTCCTC|GATTTGTCGATTTACGAATCCCCCGGGTCC
GATAGTAACCCATTGCGTCATCTACAACTA|ATCCGAGAGGTGGAGTTCGACTACAACTAA
GCTCCTTAGGGGGGACCCGCTTATGCAAAC|GCTACAACTAATTCGGTTGATCCGAGAGGT
GCTGGATTCCAGACCAAGGGCCCCCGACAT|GGCCTCGATACGGAGCCCGTGAGATTAGAT
CACGGCGACTACTGCAAGCCTCCTCGCACA|GTCGATTTACGAATCCCCCGGGTCCATTGT
GGTGCGGGGTCATCTGTAAAACCAACTTGC|GAGAGGTGACGATCTCAATAATGACGGGCT
GGTATGAAAGTAAAGCTCCTTAGGGGGGAC|TCAGGTTGGATGGCGCTACAACTAATTCGG
CTTCGTCCGCGCATAGGATCTCGCATGTCA|CATTAACTTTCGCGCCTGGATATGGACTGT
TGAAAGATAGTAACCCATTGCGTCATCTAC|GGTTGATCCGAGAGGTGGAGTTCGACTACA
CATCAAAGGGAACCTGCTCACAGTTCCTAC|CCGAGAGGTGTTCAGTACTACAACTAATTC
AAGCATCAAAGGGAACCTGCTCACAGTTCC|GATCCGAGAGGTGTTCAGTACTACAACTAA
GATCCGAGAGGTGCCTTTAACGGTCTCACC|CATACAAGCCCCATTCTGACCCCAGTCACT
TGATACGCGACTCACGGCGGACAGAACGGC|GATGGTGAACACGGCGACTACTGCAAGCCT
CATCTCTTGAGATGGCCGAATTATTGAGCG|CTCACCTCCAGAGCCGTCGGATGTAAGTTG
TTAACGGTCTCACCTCCAGAGCCGTCGGAT|TGACCCCAGTCACTTGCAGCCCAGCGGATG
TCAATTCGGTTTAGTTCCTACAACTAATTC|TACCTCCGTCCAGGCTTCGCTTCGCTAGCT
AATCCCCCGGGTCCATTGTCATTGCGCCCT|CATGTCTAGACGATTCCCGAAGTACAAGAT
ATCTCTTCCTTGTGCTTTATGTAAAATCCT|AATGTAATGATCTTGTCCTACAACTAATTC
TGCGTATCAACCCGGTATGAAAGTAAAGCT|CCTCGCACACGCATCAGGTTGGATGGCGCT
CAGGGATTTTCCGCATCTCTTGAGATGGCC|TGCCTTTAACGGTCTCACCTCCAGAGCCGT
TATTAACTGACGACAACGCCTATAGATAGC|TCCGAGAGGTGATTTAACTCGTACCGACTC
GCTCTTTGATGGCTACAACTAATTCGGTTG|ACTTGCTGGGTTATACGACTGAGTGTGAAA
ACTACTGCAAGCCTCCTCGCACACGCATCA|TACGAATCCCCCGGGTCCATTGTCATTGCG
CACAGTTCCTACAACTAATTCGGTTGATCC|TACAACTAATTCGGTTGATCCGAGAGGTGG
AAAATCCTACAACTAATTCGGTTGATCCGA|ACTAATTCGGTTGATCCGAGAGGTGGAATA
AGGTGGAGTTCGACTACAACTAATTCGGTT|CAGGGATTTTCCGCATCTCTTGAGATGGCC
ATCCCCCGGGTCCATTGTCATTGCGCCCTA|ATGTCTAGACGATTCCCGAAGTACAAGATG
ACATTAACTTTCGCGCCTGGATATGGACTG|TAATTCGGTTGATCCGAGAGGTGGACAAAC
TCGCGCCTGGATATGGACTGTTAATATCCT|GATCCGAGAGGTGGACAAACGGCTGGATTC
ATCAATTCGGTTTAGTTCCTACAACTAATT|ATACCTCCGTCCAGGCTTCGCTTCGCTAGC
GATTCCAGACCAAGGGCCCCCGACATCAAT|TCGATACGGAGCCCGTGAGATTAGATACCT
TGTAAAACCAACTTGCTGGGTTATACGACT|TCAATAATGACGGGCTCTCCCGCTACAACT
CTGGGTTATACGACTGAGTGTGAAAGATAG|TCTCCCGCTACAACTAATTCGGTTGATCCG
ATTCGGTTGATCCGAGAGGTGTTCAGTACT|AGCTACAACTAATTCGGTTGATCCGAGAGG
GAGCCCGTGAGATTAGATACCTCCGTCCAG|ATCCGAGAGGTGCAGTACGTCTACAACCTA
AGTGTCCTATGGCTGCTCTTTGATGGCTAC|CATCTGTAAAACCAACTTGCTGGGTTATAC
GATCCGAGAGGTGCGGGGTCATCTGTAAAA|GGTTGATCCGAGAGGTGACGATCTCAATAA
AACTAATTCGGTTGATCCGAGAGGTGGACA|GGTTGATCCGAGAGGTGGCTAACGTCTCAA
TACTGCAAGCCTCCTCGCACACGCATCAGG|CGAATCCCCCGGGTCCATTGTCATTGCGCC
GTGGCTAACGTCTCAAGTCCGGCCTCGATA|CTGCTCTTTGATGGCTACAACTAATTCGGT
ACCTGGTCTACTTATTCACGTAGCTACAAC|GTCTGAGCACATCTCTTCCTTGTGCTTTAT
CCGAGAGGTGATGATACGCGACTCACGGCG|TTATTGAGCGTGATGGTGAACACGGCGACT
CAACTAATTCGGTTGATCCGAGAGGTGGAA|ATTCGGTTTAGTTCCTACAACTAATTCGGT
GGTCCATTGTCATTGCGCCCTATGGCAGAC|ACGATTCCCGAAGTACAAGATGAACCGTCA
GATGATACGCGACTCACGGCGGACAGAACG|GTGATGGTGAACACGGCGACTACTGCAAGC
AACTAATTCGGTTGATCCGAGAGGTGACGA|CGACTCACGGCGGACAGAACGGCTGCGTAT
GACACATTAACTTTCGCGCCTGGATATGGA|AACTAATTCGGTTGATCCGAGAGGTGGACA
GATCCGAGAGGTGATTTAACTCGTACCGAC|TGGAATAAGCATCAAAGGGAACCTGCTCAC
TTAACTTTCGCGCCTGGATATGGACTGTTA|TTCGGTTGATCCGAGAGGTGGACAAACGGC
AGGGAACCTGCTCACAGTTCCTACAACTAA|GGTGTTCAGTACTACAACTAATTCGGTTGA
CGCATCAGGTTGGATGGCGCTACAACTAAT|CATTGCGCCCTATGGCAGACTGTTACGGAA
CTAATTCGGTTGATCCGAGAGGTGATTTAA|GATCCGAGAGGTGGAATAAGCATCAAAGGG
TAGTTCCTACAACTAATTCGGTTGATCCGA|AGGCTTCGCTTCGCTAGCTACAACTAATTC
TACTACAACTAATTCGGTTGATCCGAGAGG|GAGGTGATGAAATGGGAAGTGTCCTATGGC
TATTCACGTAGCTACAACTAATTCGGTTGA|CTCTTCCTTGTGCTTTATGTAAAATCCTAC
ACTAATTCGGTTGATCCGAGAGGTGGAGTT|GGGGGACCCGCTTATGCAAACAGGGATTTT
AAGTCTGAGCACATCTCTTCCTTGTGCTTT|TAATATCCTCTTAATGTAATGATCTTGTCC
ATAATGACGGGCTCTCCCGCTACAACTAAT|CGGTATGAAAGTAAAGCTCCTTAGGGGGGA
TTGATCCGAGAGGTGCAGTACGTCTACAAC|AAAGATAGTAACCCATTGCGTCATCTACAA
CTAATTCGGTTGATCCGAGAGGTGGAGTTC|GGGGACCCGCTTATGCAAACAGGGATTTTC
GAGGTGATTTAACTCGTACCGACTCGTGGT|AGCATCAAAGGGAACCTGCTCACAGTTCCT
AATTCGGTTGATCCGAGAGGTGATTTAACT|TCCGAGAGGTGGAATAAGCATCAAAGGGAA
TGCAGTACGTCTACAACCTACAACTAATTC|CATTGCGTCATCTACAACTAATTCGGTTGA
ACAGAACGGCTGCGTATCAACCCGGTATGA|CTGCAAGCCTCCTCGCACACGCATCAGGTT
GATGGTGAACACGGCGACTACTGCAAGCCT|GCGTGATTTGTCGATTTACGAATCCCCCGG
GTCATCTGTAAAACCAACTTGCTGGGTTAT|ACGATCTCAATAATGACGGGCTCTCCCGCT
TATGGCAGACTGTTACGGAACCTTTCCATA|TGAACCGTCAAGGACTAGATCTCGCTTCCA
GACAAACGGCTGGATTCCAGACCAAGGGCC|TCAAGTCCGGCCTCGATACGGAGCCCGTGA
GGACAGAACGGCTGCGTATCAACCCGGTAT|TACTGCAAGCCTCCTCGCACACGCATCAGG
TGGCGCTACAACTAATTCGGTTGATCCGAG|GCAGACTGTTACGGAACCTTTCCATACAAG
CTACAACTAATTCGGTTGATCCGAGAGGTG|TCAATTCGGTTTAGTTCCTACAACTAATTC
CGAGAGGTGCAGTACGTCTACAACCTACAA|AGTAACCCATTGCGTCATCTACAACTAATT
TTCGGTTGATCCGAGAGGTGATGATACGCG|GATGGCCGAATTATTGAGCGTGATGGTGAA
CTAATTCGGTTGATCCGAGAGGTGATGAAA|GAGGTGTAATTCGGTTGATCCGAGAGGTGC
GGCGGACAGAACGGCTGCGTATCAACCCGG|GACTACTGCAAGCCTCCTCGCACACGCATC
GACTGTTAATATCCTCTTAATGTAATGATC|CAAACGGCTGGATTCCAGACCAAGGGCCCC
CTTATGCAAACAGGGATTTTCCGCATCTCT|ATCCGAGAGGTGCCTTTAACGGTCTCACCT
CATCGCCTTCGTCCGCGCATAGGATCTCGC|AGGACACATTAACTTTCGCGCCTGGATATG
TACAACTAATTCGGTTGATCCGAGAGGTGT|GCTTCGCTAGCTACAACTAATTCGGTTGAT
ACCCGCTTATGCAAACAGGGATTTTCCGCA|GGTTGATCCGAGAGGTGCCTTTAACGGTCT
CGGTTGATCCGAGAGGTGACGATCTCAATA|GGCGGACAGAACGGCTGCGTATCAACCCGG
CCTATGGCTGCTCTTTGATGGCTACAACTA|GTAAAACCAACTTGCTGGGTTATACGACTG
TCCGAGAGGTGCAGTACGTCTACAACCTAC|ATAGTAACCCATTGCGTCATCTACAACTAA
TAGGATCTCGCATGTCAAAGTCTGAGCACA|GCCTGGATATGGACTGTTAATATCCTCTTA
TGATCCGAGAGGTGGAGTTCGACTACAACT|TTATGCAAACAGGGATTTTCCGCATCTCTT
GGTTGATCCGAGAGGTGGACAAACGGCTGG|GAGAGGTGGCTAACGTCTCAAGTCCGGCCT
TGATCCGAGAGGTGATGATACGCGACTCAC|CGAATTATTGAGCGTGATGGTGAACACGGC
ACTAATTCGGTTGATCCGAGAGGTGACGAT|GACTCACGGCGGACAGAACGGCTGCGTATC
GTAAAGCTCCTTAGGGGGGACCCGCTTATG|ATGGCGCTACAACTAATTCGGTTGATCCGA
GTTGATCCGAGAGGTGGAATAAGCATCAAA|TTCCTACAACTAATTCGGTTGATCCGAGAG
ACTTGCTGGGTTATACGACTGAGTGTGAAA|CGGGCTCTCCCGCTACAACTAATTCGGTTG
TCAAGTCCGGCCTCGATACGGAGCCCGTGA|GGCTACAACTAATTCGGTTGATCCGAGAGG
TCGGTTGATCCGAGAGGTGTTCAGTACTAC|CTACAACTAATTCGGTTGATCCGAGAGGTG
CCTCCGTCCAGGCTTCGCTTCGCTAGCTAC|TCTACAACCTACAACTAATTCGGTTGATCC
GAGAGGTGGACAAACGGCTGGATTCCAGAC|CTAACGTCTCAAGTCCGGCCTCGATACGGA
TAGATACCTCCGTCCAGGCTTCGCTTCGCT|AGTACGTCTACAACCTACAACTAATTCGGT
GATTTAACTCGTACCGACTCGTGGTAGGAC|CAAAGGGAACCTGCTCACAGTTCCTACAAC
GCCTGGATATGGACTGTTAATATCCTCTTA|CGAGAGGTGGACAAACGGCTGGATTCCAGA
AAACGGCTGGATTCCAGACCAAGGGCCCCC|AGTCCGGCCTCGATACGGAGCCCGTGAGAT
CGATTTACGAATCCCCCGGGTCCATTGTCA|ACCCACCCGCATGTCTAGACGATTCCCGAA
TAATTCGGTTGATCCGAGAGGTGGAATAAG|GGTTTAGTTCCTACAACTAATTCGGTTGAT
GTTGAGCGTGATTTGTCGATTTACGAATCC|TTATAGCGAGGCGAGGACCCACCCGCATGT
TAATTCGGTTGATCCGAGAGGTGCCTTTAA|GGAACCTTTCCATACAAGCCCCATTCTGAC
GGGGGGACCCGCTTATGCAAACAGGGATTT|TAATTCGGTTGATCCGAGAGGTGCCTTTAA
CGGTTGATCCGAGAGGTGTTGTTATTAACT|ATCCTACAACTAATTCGGTTGATCCGAGAG
TGATGATACGCGACTCACGGCGGACAGAAC|CGTGATGGTGAACACGGCGACTACTGCAAG
GGACAAACGGCTGGATTCCAGACCAAGGGC|CTCAAGTCCGGCCTCGATACGGAGCCCGTG
TCGGTTGATCCGAGAGGTGGACAAACGGCT|CCGAGAGGTGGCTAACGTCTCAAGTCCGGC
GAGAGGTGGAATAAGCATCAAAGGGAACCT|ACTAATTCGGTTGATCCGAGAGGTGTTCAG
GGTGGCTAACGTCTCAAGTCCGGCCTCGAT|GCTGCTCTTTGATGGCTACAACTAATTCGG
GAGAGGTGATGAAATGGGAAGTGTCCTATG|GATCCGAGAGGTGCGGGGTCATCTGTAAAA
ATGTCAAAGTCTGAGCACATCTCTTCCTTG|GACTGTTAATATCCTCTTAATGTAATGATC
AACGCCTATAGATAGCGAAGCCATCGCCTT|TAACTCGTACCGACTCGTGGTAGGACACAT
TTGCGCCCTATGGCAGACTGTTACGGAACC|GTACAAGATGAACCGTCAAGGACTAGATCT
AATTCGGTTGATCCGAGAGGTGAGGCTACA|ATTCGGTTGATCCGAGAGGTGATGATACGC
GGATTCCAGACCAAGGGCCCCCGACATCAA|CTCGATACGGAGCCCGTGAGATTAGATACC
TTTATGTAAAATCCTACAACTAATTCGGTT|TCCTACAACTAATTCGGTTGATCCGAGAGG
CGGATGTAAGTTGAGCGTGATTTGTCGATT|GGATGGAATTTATAGCGAGGCGAGGACCCA
GTTGATCCGAGAGGTGCCTTTAACGGTCTC|TTCCATACAAGCCCCATTCTGACCCCAGTC
CTATGGCAGACTGTTACGGAACCTTTCCAT|ATGAACCGTCAAGGACTAGATCTCGCTTCC
GGTCTCACCTCCAGAGCCGTCGGATGTAAG|CCAGTCACTTGCAGCCCAGCGGATGGAATT
CGACTCGTGGTAGGACACATTAACTTTCGC|TCACAGTTCCTACAACTAATTCGGTTGATC
CTGGATTCCAGACCAAGGGCCCCCGACATC|GCCTCGATACGGAGCCCGTGAGATTAGATA
GCGGGGTCATCTGTAAAACCAACTTGCTGG|AGGTGACGATCTCAATAATGACGGGCTCTC
CCCGGGTCCATTGTCATTGCGCCCTATGGC|CTAGACGATTCCCGAAGTACAAGATGAACC
TCGGTTGATCCGAGAGGTGTTGTTATTAAC|AATCCTACAACTAATTCGGTTGATCCGAGA
TAAGTTGAGCGTGATTTGTCGATTTACGAA|AATTTATAGCGAGGCGAGGACCCACCCGCA
AATTCGGTTGATCCGAGAGGTGTTCAGTAC|TAGCTACAACTAATTCGGTTGATCCGAGAG
ACGGCTGCGTATCAACCCGGTATGAAAGTA|AGCCTCCTCGCACACGCATCAGGTTGGATG
AGTCTGAGCACATCTCTTCCTTGTGCTTTA|AATATCCTCTTAATGTAATGATCTTGTCCT
AACTAATTCGGTTGATCCGAGAGGTGATTT|TTGATCCGAGAGGTGGAATAAGCATCAAAG
ATTAACTTTCGCGCCTGGATATGGACTGTT|ATTCGGTTGATCCGAGAGGTGGACAAACGG
TGATCCGAGAGGTGGACAAACGGCTGGATT|AGGTGGCTAACGTCTCAAGTCCGGCCTCGA
AGAGGTGGCTAACGTCTCAAGTCCGGCCTC|ATGGCTGCTCTTTGATGGCTACAACTAATT
CTGAGCACATCTCTTCCTTGTGCTTTATGT|ATCCTCTTAATGTAATGATCTTGTCCTACA
ATTCGGTTGATCCGAGAGGTGAGGCTACAA|TTCGGTTGATCCGAGAGGTGATGATACGCG
GGCTCTCCCGCTACAACTAATTCGGTTGAT|AGTAAAGCTCCTTAGGGGGGACCCGCTTAT
GATCCGAGAGGTGTTCAGTACTACAACTAA|CTAATTCGGTTGATCCGAGAGGTGATGAAA
GAGGTGCGGGGTCATCTGTAAAACCAACTT|CCGAGAGGTGACGATCTCAATAATGACGGG
TGTGCTTTATGTAAAATCCTACAACTAATT|TCTTGTCCTACAACTAATTCGGTTGATCCG
ATGAAATGGGAAGTGTCCTATGGCTGCTCT|AGGTGCGGGGTCATCTGTAAAACCAACTTG
AGAGGTGAGGCTACAACTAATTCGGTTGAT|GAGGTGATGATACGCGACTCACGGCGGACA
AAACCAACTTGCTGGGTTATACGACTGAGT|TAATGACGGGCTCTCCCGCTACAACTAATT
CTCACGGCGGACAGAACGGCTGCGTATCAA|ACGGCGACTACTGCAAGCCTCCTCGCACAC
ACAACTAATTCGGTTGATCCGAGAGGTGCA|ACGACTGAGTGTGAAAGATAGTAACCCATT
GTTGATCCGAGAGGTGACGATCTCAATAAT|CGGACAGAACGGCTGCGTATCAACCCGGTA
TAATTCGGTTGATCCGAGAGGTGACGATCT|CTCACGGCGGACAGAACGGCTGCGTATCAA
GGTTGATCCGAGAGGTGATTTAACTCGTAC|GAGGTGGAATAAGCATCAAAGGGAACCTGC
GCCTTCGTCCGCGCATAGGATCTCGCATGT|CACATTAACTTTCGCGCCTGGATATGGACT
TAATTCGGTTGATCCGAGAGGTGAGGCTAC|AATTCGGTTGATCCGAGAGGTGATGATACG
GGTGAGGCTACAACTAATTCGGTTGATCCG|GTGATGATACGCGACTCACGGCGGACAGAA
TGGCTACAACTAATTCGGTTGATCCGAGAG|GTTATACGACTGAGTGTGAAAGATAGTAAC
ATACGACTGAGTGTGAAAGATAGTAACCCA|CTACAACTAATTCGGTTGATCCGAGAGGTG
GAGGTGACGATCTCAATAATGACGGGCTCT|GGCTGCGTATCAACCCGGTATGAAAGTAAA
ATTTGTCGATTTACGAATCCCCCGGGTCCA|GCGAGGACCCACCCGCATGTCTAGACGATT
CCATTGCGTCATCTACAACTAATTCGGTTG|GTGGAGTTCGACTACAACTAATTCGGTTGA
GGATGTAAGTTGAGCGTGATTTGTCGATTT|GATGGAATTTATAGCGAGGCGAGGACCCAC
ATCAGGTTGGATGGCGCTACAACTAATTCG|TGCGCCCTATGGCAGACTGTTACGGAACCT
GCATCTCTTGAGATGGCCGAATTATTGAGC|TCTCACCTCCAGAGCCGTCGGATGTAAGTT
GCAAGCCTCCTCGCACACGCATCAGGTTGG|TCCCCCGGGTCCATTGTCATTGCGCCCTAT
TCTCCCGCTACAACTAATTCGGTTGATCCG|AAAGCTCCTTAGGGGGGACCCGCTTATGCA
CATCAGGTTGGATGGCGCTACAACTAATTC|TTGCGCCCTATGGCAGACTGTTACGGAACC
GTTGATCCGAGAGGTGGACAAACGGCTGGA|AGAGGTGGCTAACGTCTCAAGTCCGGCCTC
GAGCACATCTCTTCCTTGTGCTTTATGTAA|CCTCTTAATGTAATGATCTTGTCCTACAAC
ACAACTAATTCGGTTGATCCGAGAGGTGAC|CGCGACTCACGGCGGACAGAACGGCTGCGT
GAGAGGTGACGATCTCAATAATGACGGGCT|ACGGCTGCGTATCAACCCGGTATGAAAGTA
CGCGCATAGGATCTCGCATGTCAAAGTCTG|TTTCGCGCCTGGATATGGACTGTTAATATC
CTCTTAATGTAATGATCTTGTCCTACAACT|TCCAGACCAAGGGCCCCCGACATCAATTCG
GAGGTGAGGCTACAACTAATTCGGTTGATC|AGGTGATGATACGCGACTCACGGCGGACAG
CGTCTACAACCTACAACTAATTCGGTTGAT|TCATCTACAACTAATTCGGTTGATCCGAGA
AGGGGGGACCCGCTTATGCAAACAGGGATT|CTAATTCGGTTGATCCGAGAGGTGCCTTTA
AGTACTACAACTAATTCGGTTGATCCGAGA|GAGAGGTGATGAAATGGGAAGTGTCCTATG
AGCGTGATGGTGAACACGGCGACTACTGCA|GTTGAGCGTGATTTGTCGATTTACGAATCC
AAGGGCCCCCGACATCAATTCGGTTTAGTT|CCCGTGAGATTAGATACCTCCGTCCAGGCT
TTGATCCGAGAGGTGGCTAACGTCTCAAGT|AGTGTCCTATGGCTGCTCTTTGATGGCTAC
CGCTAGCTACAACTAATTCGGTTGATCCGA|CGGTTGATCCGAGAGGTGTAATTCGGTTGA
ACGATCTCAATAATGACGGGCTCTCCCGCT|GTATCAACCCGGTATGAAAGTAAAGCTCCT
CGTCCGCGCATAGGATCTCGCATGTCAAAG|TAACTTTCGCGCCTGGATATGGACTGTTAA
TAATGACGGGCTCTCCCGCTACAACTAATT|GGTATGAAAGTAAAGCTCCTTAGGGGGGAC
TCCGCGCATAGGATCTCGCATGTCAAAGTC|ACTTTCGCGCCTGGATATGGACTGTTAATA
TCTCAATAATGACGGGCTCTCCCGCTACAA|CAACCCGGTATGAAAGTAAAGCTCCTTAGG
ATGATCTTGTCCTACAACTAATTCGGTTGA|GGCCCCCGACATCAATTCGGTTTAGTTCCT
ACAACGCCTATAGATAGCGAAGCCATCGCC|TTTAACTCGTACCGACTCGTGGTAGGACAC
GTCTACAACCTACAACTAATTCGGTTGATC|CATCTACAACTAATTCGGTTGATCCGAGAG
CTTCCTTGTGCTTTATGTAAAATCCTACAA|TAATGATCTTGTCCTACAACTAATTCGGTT
GGGACCCGCTTATGCAAACAGGGATTTTCC|TTCGGTTGATCCGAGAGGTGCCTTTAACGG
AACCAACTTGCTGGGTTATACGACTGAGTG|AATGACGGGCTCTCCCGCTACAACTAATTC
TCCGAGAGGTGTTCAGTACTACAACTAATT|AATTCGGTTGATCCGAGAGGTGATGAAATG
CCCATTGCGTCATCTACAACTAATTCGGTT|GGTGGAGTTCGACTACAACTAATTCGGTTG
GCTACAACTAATTCGGTTGATCCGAGAGGT|TGCTTTATGTAAAATCCTACAACTAATTCG
CTAATTCGGTTGATCCGAGAGGTGGAATAA|CGGTTTAGTTCCTACAACTAATTCGGTTGA
TTCCTACAACTAATTCGGTTGATCCGAGAG|CTAATTCGGTTGATCCGAGAGGTGGCTAAC
CTCACCTCCAGAGCCGTCGGATGTAAGTTG|GTCACTTGCAGCCCAGCGGATGGAATTTAT
TCTGAGCACATCTCTTCCTTGTGCTTTATG|TATCCTCTTAATGTAATGATCTTGTCCTAC
GATCCGAGAGGTGGAGTTCGACTACAACTA|TATGCAAACAGGGATTTTCCGCATCTCTTG
GATCCGAGAGGTGTTGTTATTAACTGACGA|ACAACTAATTCGGTTGATCCGAGAGGTGAT
ATTCGGTTGATCCGAGAGGTGGACAAACGG|ATCCGAGAGGTGGCTAACGTCTCAAGTCCG
GTCTACTTATTCACGTAGCTACAACTAATT|AGCACATCTCTTCCTTGTGCTTTATGTAAA
TGAGCACATCTCTTCCTTGTGCTTTATGTA|TCCTCTTAATGTAATGATCTTGTCCTACAA
CGGTTGATCCGAGAGGTGAGGCTACAACTA|GGTTGATCCGAGAGGTGATGATACGCGACT
CGACTCACGGCGGACAGAACGGCTGCGTAT|AACACGGCGACTACTGCAAGCCTCCTCGCA
GCCATCGCCTTCGTCCGCGCATAGGATCTC|GTAGGACACATTAACTTTCGCGCCTGGATA
GTTCCTACAACTAATTCGGTTGATCCGAGA|ACTAATTCGGTTGATCCGAGAGGTGGCTAA
GGTTGATCCGAGAGGTGGCTAACGTCTCAA|GAAGTGTCCTATGGCTGCTCTTTGATGGCT
GAATTATTGAGCGTGATGGTGAACACGGCG|CGGATGTAAGTTGAGCGTGATTTGTCGATT
GGTGGACAAACGGCTGGATTCCAGACCAAG|CGTCTCAAGTCCGGCCTCGATACGGAGCCC
ATCCGAGAGGTGACGATCTCAATAATGACG|CAGAACGGCTGCGTATCAACCCGGTATGAA
GATACCTCCGTCCAGGCTTCGCTTCGCTAG|TACGTCTACAACCTACAACTAATTCGGTTG
GATGTAAGTTGAGCGTGATTTGTCGATTTA|ATGGAATTTATAGCGAGGCGAGGACCCACC
GTAACCCATTGCGTCATCTACAACTAATTC|GAGAGGTGGAGTTCGACTACAACTAATTCG
CCGAGAGGTGTTCAGTACTACAACTAATTC|ATTCGGTTGATCCGAGAGGTGATGAAATGG
TATGGACTGTTAATATCCTCTTAATGTAAT|TGGACAAACGGCTGGATTCCAGACCAAGGG
ATCCGAGAGGTGTTCAGTACTACAACTAAT|TAATTCGGTTGATCCGAGAGGTGATGAAAT
AGTGTGAAAGATAGTAACCCATTGCGTCAT|ATTCGGTTGATCCGAGAGGTGGAGTTCGAC
CATCTCTTCCTTGTGCTTTATGTAAAATCC|TAATGTAATGATCTTGTCCTACAACTAATT
GGCTACAACTAATTCGGTTGATCCGAGAGG|GATACGCGACTCACGGCGGACAGAACGGCT
CAACGCCTATAGATAGCGAAGCCATCGCCT|TTAACTCGTACCGACTCGTGGTAGGACACA
CTCGATACGGAGCCCGTGAGATTAGATACC|ATTCGGTTGATCCGAGAGGTGCAGTACGTC
CCGGCCTCGATACGGAGCCCGTGAGATTAG|AACTAATTCGGTTGATCCGAGAGGTGCAGT
TTGATCCGAGAGGTGTAATTCGGTTGATCC|CGAGAGGTGAGGCTACAACTAATTCGGTTG
GGTTGATCCGAGAGGTGATGAAATGGGAAG|AATTCGGTTGATCCGAGAGGTGCGGGGTCA
CGAGAGGTGACGATCTCAATAATGACGGGC|AACGGCTGCGTATCAACCCGGTATGAAAGT
GGACACATTAACTTTCGCGCCTGGATATGG|CAACTAATTCGGTTGATCCGAGAGGTGGAC
CAAGGGCCCCCGACATCAATTCGGTTTAGT|GCCCGTGAGATTAGATACCTCCGTCCAGGC
GCGGACAGAACGGCTGCGTATCAACCCGGT|ACTACTGCAAGCCTCCTCGCACACGCATCA
TTGATCCGAGAGGTGTTCAGTACTACAACT|AACTAATTCGGTTGATCCGAGAGGTGATGA
AACCTACAACTAATTCGGTTGATCCGAGAG|CAACTAATTCGGTTGATCCGAGAGGTGAGG
GGATATGGACTGTTAATATCCTCTTAATGT|AGGTGGACAAACGGCTGGATTCCAGACCAA
CTGCAAGCCTCCTCGCACACGCATCAGGTT|AATCCCCCGGGTCCATTGTCATTGCGCCCT
CTACAACTAATTCGGTTGATCCGAGAGGTG|CATCTCTTGAGATGGCCGAATTATTGAGCG
GCCCCCGACATCAATTCGGTTTAGTTCCTA|TGAGATTAGATACCTCCGTCCAGGCTTCGC
CAGGTTGGATGGCGCTACAACTAATTCGGT|CGCCCTATGGCAGACTGTTACGGAACCTTT
AATTCGGTTGATCCGAGAGGTGCAGTACGT|GAGTGTGAAAGATAGTAACCCATTGCGTCA
TTCGGTTGATCCGAGAGGTGCGGGGTCATC|CTAATTCGGTTGATCCGAGAGGTGACGATC
AGAGGTGACGATCTCAATAATGACGGGCTC|CGGCTGCGTATCAACCCGGTATGAAAGTAA
CTTAATGTAATGATCTTGTCCTACAACTAA|CAGACCAAGGGCCCCCGACATCAATTCGGT
GCAGTACGTCTACAACCTACAACTAATTCG|ATTGCGTCATCTACAACTAATTCGGTTGAT
AACCTGCTCACAGTTCCTACAACTAATTCG|TTCAGTACTACAACTAATTCGGTTGATCCG
CGATACGGAGCCCGTGAGATTAGATACCTC|TCGGTTGATCCGAGAGGTGCAGTACGTCTA
CGGTTGATCCGAGAGGTGTTCAGTACTACA|TACAACTAATTCGGTTGATCCGAGAGGTGA
CTTTCGCGCCTGGATATGGACTGTTAATAT|GTTGATCCGAGAGGTGGACAAACGGCTGGA
TCCATTGTCATTGCGCCCTATGGCAGACTG|GATTCCCGAAGTACAAGATGAACCGTCAAG
TTCGGTTGATCCGAGAGGTGACGATCTCAA|ACGGCGGACAGAACGGCTGCGTATCAACCC
GAGAGGTGTTGTTATTAACTGACGACAACG|TAATTCGGTTGATCCGAGAGGTGATTTAAC
GAGAGGTGATGATACGCGACTCACGGCGGA|ATTGAGCGTGATGGTGAACACGGCGACTAC
AATGTAATGATCTTGTCCTACAACTAATTC|ACCAAGGGCCCCCGACATCAATTCGGTTTA
CTCTTGAGATGGCCGAATTATTGAGCGTGA|ACCTCCAGAGCCGTCGGATGTAAGTTGAGC
TAATATCCTCTTAATGTAATGATCTTGTCC|GCTGGATTCCAGACCAAGGGCCCCCGACAT
GGTTATACGACTGAGTGTGAAAGATAGTAA|CCCGCTACAACTAATTCGGTTGATCCGAGA
CGGCGACTACTGCAAGCCTCCTCGCACACG|CGATTTACGAATCCCCCGGGTCCATTGTCA
TCCCGCTACAACTAATTCGGTTGATCCGAG|AGCTCCTTAGGGGGGACCCGCTTATGCAAA
GTGGTAGGACACATTAACTTTCGCGCCTGG|TTCCTACAACTAATTCGGTTGATCCGAGAG
TCGGATGTAAGTTGAGCGTGATTTGTCGAT|CGGATGGAATTTATAGCGAGGCGAGGACCC
GTACTACAACTAATTCGGTTGATCCGAGAG|AGAGGTGATGAAATGGGAAGTGTCCTATGG
AGTTCGACTACAACTAATTCGGTTGATCCG|TTTTCCGCATCTCTTGAGATGGCCGAATTA
GATTTACGAATCCCCCGGGTCCATTGTCAT|CCCACCCGCATGTCTAGACGATTCCCGAAG
ACAACTAATTCGGTTGATCCGAGAGGTGGC|TGATGAAATGGGAAGTGTCCTATGGCTGCT
GGTTGATCCGAGAGGTGACGATCTCAATAA|GCGGACAGAACGGCTGCGTATCAACCCGGT
CGTCATCTACAACTAATTCGGTTGATCCGA|TTCGACTACAACTAATTCGGTTGATCCGAG
GAGAGGTGCGGGGTCATCTGTAAAACCAAC|ATCCGAGAGGTGACGATCTCAATAATGACG
CAACCCGGTATGAAAGTAAAGCTCCTTAGG|CACGCATCAGGTTGGATGGCGCTACAACTA
CCGAGAGGTGTTGTTATTAACTGACGACAA|ACTAATTCGGTTGATCCGAGAGGTGATTTA
GTGTGAAAGATAGTAACCCATTGCGTCATC|TTCGGTTGATCCGAGAGGTGGAGTTCGACT
TCATCTGTAAAACCAACTTGCTGGGTTATA|CGATCTCAATAATGACGGGCTCTCCCGCTA
TGTTCAGTACTACAACTAATTCGGTTGATC|GATCCGAGAGGTGATGAAATGGGAAGTGTC
ACACGCATCAGGTTGGATGGCGCTACAACT|TGTCATTGCGCCCTATGGCAGACTGTTACG
AACTAATTCGGTTGATCCGAGAGGTGTTCA|TCGCTAGCTACAACTAATTCGGTTGATCCG
CTAATTCGGTTGATCCGAGAGGTGAGGCTA|TAATTCGGTTGATCCGAGAGGTGATGATAC
GATGAAATGGGAAGTGTCCTATGGCTGCTC|GAGGTGCGGGGTCATCTGTAAAACCAACTT
AATTCGGTTGATCCGAGAGGTGGACAAACG|GATCCGAGAGGTGGCTAACGTCTCAAGTCC
TACGAATCCCCCGGGTCCATTGTCATTGCG|CCCGCATGTCTAGACGATTCCCGAAGTACA
TGATCCGAGAGGTGCCTTTAACGGTCTCAC|CCATACAAGCCCCATTCTGACCCCAGTCAC
CCAGAGCCGTCGGATGTAAGTTGAGCGTGA|GCAGCCCAGCGGATGGAATTTATAGCGAGG
GTTGATCCGAGAGGTGATGATACGCGACTC|GCCGAATTATTGAGCGTGATGGTGAACACG
TTCGGTTGATCCGAGAGGTGGAGTTCGACT|ACCCGCTTATGCAAACAGGGATTTTCCGCA
AAGTTGAGCGTGATTTGTCGATTTACGAAT|ATTTATAGCGAGGCGAGGACCCACCCGCAT
AACTAATTCGGTTGATCCGAGAGGTGGCTA|ATGAAATGGGAAGTGTCCTATGGCTGCTCT
CTGACGACAACGCCTATAGATAGCGAAGCC|AGGTGATTTAACTCGTACCGACTCGTGGTA
ACGACAACGCCTATAGATAGCGAAGCCATC|TGATTTAACTCGTACCGACTCGTGGTAGGA
TACAACTAATTCGGTTGATCCGAGAGGTGG|TTAGGGGGGACCCGCTTATGCAAACAGGGA
CTACAACTAATTCGGTTGATCCGAGAGGTG|ATACGACTGAGTGTGAAAGATAGTAACCCA
GTTGATCCGAGAGGTGAGGCTACAACTAAT|TTGATCCGAGAGGTGATGATACGCGACTCA
TTGATCCGAGAGGTGACGATCTCAATAATG|GGACAGAACGGCTGCGTATCAACCCGGTAT
GAGCGTGATGGTGAACACGGCGACTACTGC|AGTTGAGCGTGATTTGTCGATTTACGAATC
TCGGTTGATCCGAGAGGTGAGGCTACAACT|CGGTTGATCCGAGAGGTGATGATACGCGAC
TTCCGCATCTCTTGAGATGGCCGAATTATT|ACGGTCTCACCTCCAGAGCCGTCGGATGTA
CGCTTCGCTAGCTACAACTAATTCGGTTGA|TAATTCGGTTGATCCGAGAGGTGTAATTCG
TGATGGCTACAACTAATTCGGTTGATCCGA|TGGGTTATACGACTGAGTGTGAAAGATAGT
AGAACGGCTGCGTATCAACCCGGTATGAAA|GCAAGCCTCCTCGCACACGCATCAGGTTGG
ATGGACTGTTAATATCCTCTTAATGTAATG|GGACAAACGGCTGGATTCCAGACCAAGGGC
TGTCAAAGTCTGAGCACATCTCTTCCTTGT|ACTGTTAATATCCTCTTAATGTAATGATCT
CTACAACCTACAACTAATTCGGTTGATCCG|TCTACAACTAATTCGGTTGATCCGAGAGGT
GTTGTTATTAACTGACGACAACGCCTATAG|GTTGATCCGAGAGGTGATTTAACTCGTACC
ATTGAGCGTGATGGTGAACACGGCGACTAC|GTAAGTTGAGCGTGATTTGTCGATTTACGA
TACGTCTACAACCTACAACTAATTCGGTTG|CGTCATCTACAACTAATTCGGTTGATCCGA
GTCCTATGGCTGCTCTTTGATGGCTACAAC|CTGTAAAACCAACTTGCTGGGTTATACGAC
AGATAGCGAAGCCATCGCCTTCGTCCGCGC|CCGACTCGTGGTAGGACACATTAACTTTCG
CCCTATGGCAGACTGTTACGGAACCTTTCC|AGATGAACCGTCAAGGACTAGATCTCGCTT
ATCCGAGAGGTGTTGTTATTAACTGACGAC|CAACTAATTCGGTTGATCCGAGAGGTGATT
TCCGGCCTCGATACGGAGCCCGTGAGATTA|CAACTAATTCGGTTGATCCGAGAGGTGCAG
AGGTGATGATACGCGACTCACGGCGGACAG|GAGCGTGATGGTGAACACGGCGACTACTGC
CGAGAGGTGGCTAACGTCTCAAGTCCGGCC|CTATGGCTGCTCTTTGATGGCTACAACTAA
ATGAAAGTAAAGCTCCTTAGGGGGGACCCG|GGTTGGATGGCGCTACAACTAATTCGGTTG
TCTACAACTAATTCGGTTGATCCGAGAGGT|CTACAACTAATTCGGTTGATCCGAGAGGTG
AGTAAAGCTCCTTAGGGGGGACCCGCTTAT|GATGGCGCTACAACTAATTCGGTTGATCCG
GTTGATCCGAGAGGTGGCTAACGTCTCAAG|AAGTGTCCTATGGCTGCTCTTTGATGGCTA
ACAACTAATTCGGTTGATCCGAGAGGTGTT|CTTCGCTAGCTACAACTAATTCGGTTGATC
CAACTTGCTGGGTTATACGACTGAGTGTGA|GACGGGCTCTCCCGCTACAACTAATTCGGT
GCTACAACTAATTCGGTTGATCCGAGAGGT|ACTGTTACGGAACCTTTCCATACAAGCCCC
TACAACTAATTCGGTTGATCCGAGAGGTGA|ATCTCTTGAGATGGCCGAATTATTGAGCGT
AATTCGGTTGATCCGAGAGGTGCGGGGTCA|AACTAATTCGGTTGATCCGAGAGGTGACGA
CTTGCTGGGTTATACGACTGAGTGTGAAAG|GGGCTCTCCCGCTACAACTAATTCGGTTGA
TTTAGTTCCTACAACTAATTCGGTTGATCC|CCAGGCTTCGCTTCGCTAGCTACAACTAAT
CCGACATCAATTCGGTTTAGTTCCTACAAC|ATTAGATACCTCCGTCCAGGCTTCGCTTCG
GATAGCGAAGCCATCGCCTTCGTCCGCGCA|CGACTCGTGGTAGGACACATTAACTTTCGC
ACTCACGGCGGACAGAACGGCTGCGTATCA|CACGGCGACTACTGCAAGCCTCCTCGCACA
CAGAGCCGTCGGATGTAAGTTGAGCGTGAT|CAGCCCAGCGGATGGAATTTATAGCGAGGC
GCTACAACTAATTCGGTTGATCCGAGAGGT|CCTTAGGGGGGACCCGCTTATGCAAACAGG
GTAGCTACAACTAATTCGGTTGATCCGAGA|TTGTGCTTTATGTAAAATCCTACAACTAAT
ATTCACGTAGCTACAACTAATTCGGTTGAT|TCTTCCTTGTGCTTTATGTAAAATCCTACA
CTTGAGATGGCCGAATTATTGAGCGTGATG|CTCCAGAGCCGTCGGATGTAAGTTGAGCGT
ATTAGATACCTCCGTCCAGGCTTCGCTTCG|GCAGTACGTCTACAACCTACAACTAATTCG
CCTTTAACGGTCTCACCTCCAGAGCCGTCG|TTCTGACCCCAGTCACTTGCAGCCCAGCGG
CCTTAGGGGGGACCCGCTTATGCAAACAGG|ACAACTAATTCGGTTGATCCGAGAGGTGCC
GTAATTCGGTTGATCCGAGAGGTGCGGGGT|ACAACTAATTCGGTTGATCCGAGAGGTGAC
GCGCCTGGATATGGACTGTTAATATCCTCT|TCCGAGAGGTGGACAAACGGCTGGATTCCA
CTAATTCGGTTGATCCGAGAGGTGCCTTTA|CGGAACCTTTCCATACAAGCCCCATTCTGA
TCTCTTGAGATGGCCGAATTATTGAGCGTG|CACCTCCAGAGCCGTCGGATGTAAGTTGAG
TCCAGAGCCGTCGGATGTAAGTTGAGCGTG|TGCAGCCCAGCGGATGGAATTTATAGCGAG
AATTCGGTTTAGTTCCTACAACTAATTCGG|CCTCCGTCCAGGCTTCGCTTCGCTAGCTAC
CTAATTCGGTTGATCCGAGAGGTGTAATTC|CGGTTGATCCGAGAGGTGAGGCTACAACTA
AACAGGGATTTTCCGCATCTCTTGAGATGG|GGTGCCTTTAACGGTCTCACCTCCAGAGCC
AATTATTGAGCGTGATGGTGAACACGGCGA|GGATGTAAGTTGAGCGTGATTTGTCGATTT
CGCATAGGATCTCGCATGTCAAAGTCTGAG|TCGCGCCTGGATATGGACTGTTAATATCCT
GGTGATGAAATGGGAAGTGTCCTATGGCTG|CGAGAGGTGCGGGGTCATCTGTAAAACCAA
GAGGTGTTCAGTACTACAACTAATTCGGTT|GGTTGATCCGAGAGGTGATGAAATGGGAAG
TCGGTTGATCCGAGAGGTGCAGTACGTCTA|TGTGAAAGATAGTAACCCATTGCGTCATCT
AAAACCAACTTGCTGGGTTATACGACTGAG|ATAATGACGGGCTCTCCCGCTACAACTAAT
GCTTATGCAAACAGGGATTTTCCGCATCTC|GATCCGAGAGGTGCCTTTAACGGTCTCACC
TGAGATTAGATACCTCCGTCCAGGCTTCGC|AGGTGCAGTACGTCTACAACCTACAACTAA
TCCTACAACTAATTCGGTTGATCCGAGAGG|TAATTCGGTTGATCCGAGAGGTGGCTAACG
TCCTCTTAATGTAATGATCTTGTCCTACAA|ATTCCAGACCAAGGGCCCCCGACATCAATT
ATCTACAACTAATTCGGTTGATCCGAGAGG|ACTACAACTAATTCGGTTGATCCGAGAGGT
CCTATAGATAGCGAAGCCATCGCCTTCGTC|TCGTACCGACTCGTGGTAGGACACATTAAC
TAATTCGGTTGATCCGAGAGGTGGACAAAC|TGATCCGAGAGGTGGCTAACGTCTCAAGTC
CTAGCTACAACTAATTCGGTTGATCCGAGA|GTTGATCCGAGAGGTGTAATTCGGTTGATC
GGCTGGATTCCAGACCAAGGGCCCCCGACA|CGGCCTCGATACGGAGCCCGTGAGATTAGA
CCTGCTCACAGTTCCTACAACTAATTCGGT|CAGTACTACAACTAATTCGGTTGATCCGAG
TTATGCAAACAGGGATTTTCCGCATCTCTT|TCCGAGAGGTGCCTTTAACGGTCTCACCTC
GAGAGGTGTAATTCGGTTGATCCGAGAGGT|TGAGGCTACAACTAATTCGGTTGATCCGAG
ACTGCAAGCCTCCTCGCACACGCATCAGGT|GAATCCCCCGGGTCCATTGTCATTGCGCCC
AGCTACAACTAATTCGGTTGATCCGAGAGG|TGATCCGAGAGGTGTAATTCGGTTGATCCG
TGAGCGTGATGGTGAACACGGCGACTACTG|AAGTTGAGCGTGATTTGTCGATTTACGAAT
CATCTGTAAAACCAACTTGCTGGGTTATAC|GATCTCAATAATGACGGGCTCTCCCGCTAC
GAGGTGGAGTTCGACTACAACTAATTCGGT|ACAGGGATTTTCCGCATCTCTTGAGATGGC
CTACAACTAATTCGGTTGATCCGAGAGGTG|CTTAGGGGGGACCCGCTTATGCAAACAGGG
TTGAGATGGCCGAATTATTGAGCGTGATGG|TCCAGAGCCGTCGGATGTAAGTTGAGCGTG
CAGAACGGCTGCGTATCAACCCGGTATGAA|TGCAAGCCTCCTCGCACACGCATCAGGTTG
AGTAACCCATTGCGTCATCTACAACTAATT|CGAGAGGTGGAGTTCGACTACAACTAATTC
CACACGCATCAGGTTGGATGGCGCTACAAC|TTGTCATTGCGCCCTATGGCAGACTGTTAC
GTAGGACACATTAACTTTCGCGCCTGGATA|CTACAACTAATTCGGTTGATCCGAGAGGTG
CTTGTCCTACAACTAATTCGGTTGATCCGA|CCGACATCAATTCGGTTTAGTTCCTACAAC
CGCTACAACTAATTCGGTTGATCCGAGAGG|GACTGTTACGGAACCTTTCCATACAAGCCC
GATCCGAGAGGTGTAATTCGGTTGATCCGA|AGAGGTGAGGCTACAACTAATTCGGTTGAT
GACCTGGTCTACTTATTCACGTAGCTACAA|AGTCTGAGCACATCTCTTCCTTGTGCTTTA
AGCCATCGCCTTCGTCCGCGCATAGGATCT|GGTAGGACACATTAACTTTCGCGCCTGGAT
AACGGCTGGATTCCAGACCAAGGGCCCCCG|GTCCGGCCTCGATACGGAGCCCGTGAGATT
GAGAGGTGCCTTTAACGGTCTCACCTCCAG|AAGCCCCATTCTGACCCCAGTCACTTGCAG
ACAAACGGCTGGATTCCAGACCAAGGGCCC|CAAGTCCGGCCTCGATACGGAGCCCGTGAG
CTTTATGTAAAATCCTACAACTAATTCGGT|GTCCTACAACTAATTCGGTTGATCCGAGAG
GCTGGGTTATACGACTGAGTGTGAAAGATA|CTCTCCCGCTACAACTAATTCGGTTGATCC
AGGTGCAGTACGTCTACAACCTACAACTAA|ACCCATTGCGTCATCTACAACTAATTCGGT
AACTTTCGCGCCTGGATATGGACTGTTAAT|CGGTTGATCCGAGAGGTGGACAAACGGCTG
AATTCGGTTGATCCGAGAGGTGATGATACG|GAGATGGCCGAATTATTGAGCGTGATGGTG
TCCGAGAGGTGATGATACGCGACTCACGGC|ATTATTGAGCGTGATGGTGAACACGGCGAC
TAGCTACAACTAATTCGGTTGATCCGAGAG|TGTGCTTTATGTAAAATCCTACAACTAATT
CAACTAATTCGGTTGATCCGAGAGGTGTTC|TTCGCTAGCTACAACTAATTCGGTTGATCC
CTAATTCGGTTGATCCGAGAGGTGGCTAAC|GAAATGGGAAGTGTCCTATGGCTGCTCTTT
CCCGACATCAATTCGGTTTAGTTCCTACAA|GATTAGATACCTCCGTCCAGGCTTCGCTTC
GCGCATAGGATCTCGCATGTCAAAGTCTGA|TTCGCGCCTGGATATGGACTGTTAATATCC
TCACGGCGGACAGAACGGCTGCGTATCAAC|CGGCGACTACTGCAAGCCTCCTCGCACACG
CTTCGCTTCGCTAGCTACAACTAATTCGGT|AACTAATTCGGTTGATCCGAGAGGTGTAAT
GCTCTCCCGCTACAACTAATTCGGTTGATC|GTAAAGCTCCTTAGGGGGGACCCGCTTATG
AATGACGGGCTCTCCCGCTACAACTAATTC|GTATGAAAGTAAAGCTCCTTAGGGGGGACC
CTGGATATGGACTGTTAATATCCTCTTAAT|AGAGGTGGACAAACGGCTGGATTCCAGACC
GTTCGACTACAACTAATTCGGTTGATCCGA|TTTCCGCATCTCTTGAGATGGCCGAATTAT
CAATAATGACGGGCTCTCCCGCTACAACTA|CCCGGTATGAAAGTAAAGCTCCTTAGGGGG
AGGCTACAACTAATTCGGTTGATCCGAGAG|TGATACGCGACTCACGGCGGACAGAACGGC
TACAACTAATTCGGTTGATCCGAGAGGTGA|ACGCGACTCACGGCGGACAGAACGGCTGCG
CCTATGGCAGACTGTTACGGAACCTTTCCA|GATGAACCGTCAAGGACTAGATCTCGCTTC
CGGTTGATCCGAGAGGTGATGAAATGGGAA|TAATTCGGTTGATCCGAGAGGTGCGGGGTC
CCGGTATGAAAGTAAAGCTCCTTAGGGGGG|CATCAGGTTGGATGGCGCTACAACTAATTC
GAGATGGCCGAATTATTGAGCGTGATGGTG|CAGAGCCGTCGGATGTAAGTTGAGCGTGAT
ATGGCTACAACTAATTCGGTTGATCCGAGA|GGTTATACGACTGAGTGTGAAAGATAGTAA
TGAGATGGCCGAATTATTGAGCGTGATGGT|CCAGAGCCGTCGGATGTAAGTTGAGCGTGA
CATCAATTCGGTTTAGTTCCTACAACTAAT|GATACCTCCGTCCAGGCTTCGCTTCGCTAG
TTGATCCGAGAGGTGGAATAAGCATCAAAG|TCCTACAACTAATTCGGTTGATCCGAGAGG
GGAATAAGCATCAAAGGGAACCTGCTCACA|CGGTTGATCCGAGAGGTGTTCAGTACTACA
TTGATCCGAGAGGTGCCTTTAACGGTCTCA|TCCATACAAGCCCCATTCTGACCCCAGTCA
TCCGAGAGGTGGCTAACGTCTCAAGTCCGG|TCCTATGGCTGCTCTTTGATGGCTACAACT
CTCTTCCTTGTGCTTTATGTAAAATCCTAC|TGTAATGATCTTGTCCTACAACTAATTCGG
TCGACTACAACTAATTCGGTTGATCCGAGA|TCCGCATCTCTTGAGATGGCCGAATTATTG
GTGCAGTACGTCTACAACCTACAACTAATT|CCATTGCGTCATCTACAACTAATTCGGTTG
ACGCATCAGGTTGGATGGCGCTACAACTAA|TCATTGCGCCCTATGGCAGACTGTTACGGA
GATCCGAGAGGTGGCTAACGTCTCAAGTCC|TGTCCTATGGCTGCTCTTTGATGGCTACAA
ACGAATCCCCCGGGTCCATTGTCATTGCGC|CCGCATGTCTAGACGATTCCCGAAGTACAA
GCGTCATCTACAACTAATTCGGTTGATCCG|GTTCGACTACAACTAATTCGGTTGATCCGA
AATTCGGTTGATCCGAGAGGTGCCTTTAAC|GAACCTTTCCATACAAGCCCCATTCTGACC
GACTCACGGCGGACAGAACGGCTGCGTATC|ACACGGCGACTACTGCAAGCCTCCTCGCAC
TTCCAGACCAAGGGCCCCCGACATCAATTC|GATACGGAGCCCGTGAGATTAGATACCTCC
TAACGTCTCAAGTCCGGCCTCGATACGGAG|CTTTGATGGCTACAACTAATTCGGTTGATC
TACGGAGCCCGTGAGATTAGATACCTCCGT|GTTGATCCGAGAGGTGCAGTACGTCTACAA
TCGTGGTAGGACACATTAACTTTCGCGCCT|AGTTCCTACAACTAATTCGGTTGATCCGAG
TTCGCTAGCTACAACTAATTCGGTTGATCC|TTCGGTTGATCCGAGAGGTGTAATTCGGTT
GTGAGGCTACAACTAATTCGGTTGATCCGA|TGATGATACGCGACTCACGGCGGACAGAAC
GTCCGCGCATAGGATCTCGCATGTCAAAGT|AACTTTCGCGCCTGGATATGGACTGTTAAT
CCGCATCTCTTGAGATGGCCGAATTATTGA|GGTCTCACCTCCAGAGCCGTCGGATGTAAG
AACTAATTCGGTTGATCCGAGAGGTGCCTT|TACGGAACCTTTCCATACAAGCCCCATTCT
GAGGTGTAATTCGGTTGATCCGAGAGGTGC|AGGCTACAACTAATTCGGTTGATCCGAGAG
GAGCCGTCGGATGTAAGTTGAGCGTGATTT|GCCCAGCGGATGGAATTTATAGCGAGGCGA
GACTACAACTAATTCGGTTGATCCGAGAGG|CGCATCTCTTGAGATGGCCGAATTATTGAG
ATAGATAGCGAAGCCATCGCCTTCGTCCGC|TACCGACTCGTGGTAGGACACATTAACTTT
TAACTCGTACCGACTCGTGGTAGGACACAT|GGGAACCTGCTCACAGTTCCTACAACTAAT
AGAGGTGTAATTCGGTTGATCCGAGAGGTG|GAGGCTACAACTAATTCGGTTGATCCGAGA
TGGATTCCAGACCAAGGGCCCCCGACATCA|CCTCGATACGGAGCCCGTGAGATTAGATAC
CCCCGACATCAATTCGGTTTAGTTCCTACA|AGATTAGATACCTCCGTCCAGGCTTCGCTT
GGTTGATCCGAGAGGTGCAGTACGTCTACA|TGAAAGATAGTAACCCATTGCGTCATCTAC
GAAGTGTCCTATGGCTGCTCTTTGATGGCT|GTCATCTGTAAAACCAACTTGCTGGGTTAT
TAATGTAATGATCTTGTCCTACAACTAATT|GACCAAGGGCCCCCGACATCAATTCGGTTT
GTTATACGACTGAGTGTGAAAGATAGTAAC|CCGCTACAACTAATTCGGTTGATCCGAGAG
CGTGGTAGGACACATTAACTTTCGCGCCTG|GTTCCTACAACTAATTCGGTTGATCCGAGA
AGGTGATTTAACTCGTACCGACTCGTGGTA|GCATCAAAGGGAACCTGCTCACAGTTCCTA
CTCGCATGTCAAAGTCTGAGCACATCTCTT|ATATGGACTGTTAATATCCTCTTAATGTAA
AGGTGTTCAGTACTACAACTAATTCGGTTG|GTTGATCCGAGAGGTGATGAAATGGGAAGT
CTCTCCCGCTACAACTAATTCGGTTGATCC|TAAAGCTCCTTAGGGGGGACCCGCTTATGC
CGAGAGGTGCCTTTAACGGTCTCACCTCCA|CAAGCCCCATTCTGACCCCAGTCACTTGCA
ATAAGCATCAAAGGGAACCTGCTCACAGTT|TTGATCCGAGAGGTGTTCAGTACTACAACT
CAACTAATTCGGTTGATCCGAGAGGTGACG|GCGACTCACGGCGGACAGAACGGCTGCGTA
TCAAAGTCTGAGCACATCTCTTCCTTGTGC|TGTTAATATCCTCTTAATGTAATGATCTTG
CCGCTACAACTAATTCGGTTGATCCGAGAG|CTCCTTAGGGGGGACCCGCTTATGCAAACA
GAGAGGTGAGGCTACAACTAATTCGGTTGA|AGAGGTGATGATACGCGACTCACGGCGGAC
CTTGTGCTTTATGTAAAATCCTACAACTAA|GATCTTGTCCTACAACTAATTCGGTTGATC
TCTCTTCCTTGTGCTTTATGTAAAATCCTA|ATGTAATGATCTTGTCCTACAACTAATTCG
CGTGAGATTAGATACCTCCGTCCAGGCTTC|AGAGGTGCAGTACGTCTACAACCTACAACT
TCCCCCGGGTCCATTGTCATTGCGCCCTAT|TGTCTAGACGATTCCCGAAGTACAAGATGA
ATGGTGAACACGGCGACTACTGCAAGCCTC|CGTGATTTGTCGATTTACGAATCCCCCGGG
ATACCTCCGTCCAGGCTTCGCTTCGCTAGC|ACGTCTACAACCTACAACTAATTCGGTTGA
ACTAATTCGGTTGATCCGAGAGGTGCAGTA|ACTGAGTGTGAAAGATAGTAACCCATTGCG
TCGGTTGATCCGAGAGGTGGAGTTCGACTA|CCCGCTTATGCAAACAGGGATTTTCCGCAT
TGTCCTACAACTAATTCGGTTGATCCGAGA|GACATCAATTCGGTTTAGTTCCTACAACTA
CCCGCTTATGCAAACAGGGATTTTCCGCAT|GTTGATCCGAGAGGTGCCTTTAACGGTCTC
CGGTTGATCCGAGAGGTGATTTAACTCGTA|AGAGGTGGAATAAGCATCAAAGGGAACCTG
TTCGGTTGATCCGAGAGGTGGCTAACGTCT|TGGGAAGTGTCCTATGGCTGCTCTTTGATG
TTTAACGGTCTCACCTCCAGAGCCGTCGGA|CTGACCCCAGTCACTTGCAGCCCAGCGGAT
TGAAAGTAAAGCTCCTTAGGGGGGACCCGC|GTTGGATGGCGCTACAACTAATTCGGTTGA
TTATGTAAAATCCTACAACTAATTCGGTTG|CCTACAACTAATTCGGTTGATCCGAGAGGT
GAAAGATAGTAACCCATTGCGTCATCTACA|GTTGATCCGAGAGGTGGAGTTCGACTACAA
GGCGCTACAACTAATTCGGTTGATCCGAGA|CAGACTGTTACGGAACCTTTCCATACAAGC
CAACTAATTCGGTTGATCCGAGAGGTGTTG|TTATGTAAAATCCTACAACTAATTCGGTTG
CCGAGAGGTGGAATAAGCATCAAAGGGAAC|CAACTAATTCGGTTGATCCGAGAGGTGTTC
GGTTGATCCGAGAGGTGTTGTTATTAACTG|TCCTACAACTAATTCGGTTGATCCGAGAGG
ATTGCGTCATCTACAACTAATTCGGTTGAT|GGAGTTCGACTACAACTAATTCGGTTGATC
GACGATCTCAATAATGACGGGCTCTCCCGC|CGTATCAACCCGGTATGAAAGTAAAGCTCC
GTACCGACTCGTGGTAGGACACATTAACTT|CTGCTCACAGTTCCTACAACTAATTCGGTT
GATCCGAGAGGTGGACAAACGGCTGGATTC|GGTGGCTAACGTCTCAAGTCCGGCCTCGAT
CCAAGGGCCCCCGACATCAATTCGGTTTAG|AGCCCGTGAGATTAGATACCTCCGTCCAGG
ATAGGATCTCGCATGTCAAAGTCTGAGCAC|CGCCTGGATATGGACTGTTAATATCCTCTT
TTAGTTCCTACAACTAATTCGGTTGATCCG|CAGGCTTCGCTTCGCTAGCTACAACTAATT
AATAATGACGGGCTCTCCCGCTACAACTAA|CCGGTATGAAAGTAAAGCTCCTTAGGGGGG
CCTACAACTAATTCGGTTGATCCGAGAGGT|ACTAATTCGGTTGATCCGAGAGGTGAGGCT
ACACATTAACTTTCGCGCCTGGATATGGAC|ACTAATTCGGTTGATCCGAGAGGTGGACAA
CTACAACTAATTCGGTTGATCCGAGAGGTG|ATTCGGTTGATCCGAGAGGTGGCTAACGTC
TAATTCGGTTGATCCGAGAGGTGCAGTACG|TGAGTGTGAAAGATAGTAACCCATTGCGTC
CCTCTTAATGTAATGATCTTGTCCTACAAC|TTCCAGACCAAGGGCCCCCGACATCAATTC
CCGTCCAGGCTTCGCTTCGCTAGCTACAAC|ACAACCTACAACTAATTCGGTTGATCCGAG
ACTAATTCGGTTGATCCGAGAGGTGTTCAG|CGCTAGCTACAACTAATTCGGTTGATCCGA
TGATCCGAGAGGTGTTGTTATTAACTGACG|TACAACTAATTCGGTTGATCCGAGAGGTGA
GAGGTGCAGTACGTCTACAACCTACAACTA|AACCCATTGCGTCATCTACAACTAATTCGG
TGACGATCTCAATAATGACGGGCTCTCCCG|GCGTATCAACCCGGTATGAAAGTAAAGCTC
CGGTTGATCCGAGAGGTGCCTTTAACGGTC|CTTTCCATACAAGCCCCATTCTGACCCCAG
CCGCTTATGCAAACAGGGATTTTCCGCATC|TTGATCCGAGAGGTGCCTTTAACGGTCTCA
CTAATTCGGTTGATCCGAGAGGTGCAGTAC|CTGAGTGTGAAAGATAGTAACCCATTGCGT
GCGACTCACGGCGGACAGAACGGCTGCGTA|GAACACGGCGACTACTGCAAGCCTCCTCGC
TCGCTTCGCTAGCTACAACTAATTCGGTTG|CTAATTCGGTTGATCCGAGAGGTGTAATTC
TACCAAGACCTGGTCTACTTATTCACGTAG|TGTCAAAGTCTGAGCACATCTCTTCCTTGT
TCGGTTGATCCGAGAGGTGACGATCTCAAT|CGGCGGACAGAACGGCTGCGTATCAACCCG
TCTCGCATGTCAAAGTCTGAGCACATCTCT|GATATGGACTGTTAATATCCTCTTAATGTA
TCCGAGAGGTGATTTAACTCGTACCGACTC|GAATAAGCATCAAAGGGAACCTGCTCACAG
GTGAGATTAGATACCTCCGTCCAGGCTTCG|GAGGTGCAGTACGTCTACAACCTACAACTA
ACGGCGGACAGAACGGCTGCGTATCAACCC|GCGACTACTGCAAGCCTCCTCGCACACGCA
GCTGCTCTTTGATGGCTACAACTAATTCGG|CCAACTTGCTGGGTTATACGACTGAGTGTG
GTATCAACCCGGTATGAAAGTAAAGCTCCT|CGCACACGCATCAGGTTGGATGGCGCTACA
ATCCGAGAGGTGATGATACGCGACTCACGG|AATTATTGAGCGTGATGGTGAACACGGCGA
ACAACCTACAACTAATTCGGTTGATCCGAG|TACAACTAATTCGGTTGATCCGAGAGGTGA
AGAGGTGATGATACGCGACTCACGGCGGAC|TTGAGCGTGATGGTGAACACGGCGACTACT
AGAGGTGATTTAACTCGTACCGACTCGTGG|AAGCATCAAAGGGAACCTGCTCACAGTTCC
GCCTCCTCGCACACGCATCAGGTTGGATGG|CCGGGTCCATTGTCATTGCGCCCTATGGCA
CTGCTCACAGTTCCTACAACTAATTCGGTT|AGTACTACAACTAATTCGGTTGATCCGAGA
TGATTTGTCGATTTACGAATCCCCCGGGTC|AGGCGAGGACCCACCCGCATGTCTAGACGA
TGGAGTTCGACTACAACTAATTCGGTTGAT|GGATTTTCCGCATCTCTTGAGATGGCCGAA
TCGGTTGATCCGAGAGGTGCCTTTAACGGT|CCTTTCCATACAAGCCCCATTCTGACCCCA
CGCACACGCATCAGGTTGGATGGCGCTACA|CATTGTCATTGCGCCCTATGGCAGACTGTT
TCCAGGCTTCGCTTCGCTAGCTACAACTAA|ACCTACAACTAATTCGGTTGATCCGAGAGG
TCGGTTGATCCGAGAGGTGATTTAACTCGT|GAGAGGTGGAATAAGCATCAAAGGGAACCT
GAGGTGATGATACGCGACTCACGGCGGACA|TGAGCGTGATGGTGAACACGGCGACTACTG
TGCGGGGTCATCTGTAAAACCAACTTGCTG|GAGGTGACGATCTCAATAATGACGGGCTCT
GTGATGAAATGGGAAGTGTCCTATGGCTGC|GAGAGGTGCGGGGTCATCTGTAAAACCAAC
TGATTTAACTCGTACCGACTCGTGGTAGGA|TCAAAGGGAACCTGCTCACAGTTCCTACAA
TGATCCGAGAGGTGCGGGGTCATCTGTAAA|CGGTTGATCCGAGAGGTGACGATCTCAATA
CGGCCTCGATACGGAGCCCGTGAGATTAGA|ACTAATTCGGTTGATCCGAGAGGTGCAGTA
TGAGTGTGAAAGATAGTAACCCATTGCGTC|TAATTCGGTTGATCCGAGAGGTGGAGTTCG
GATCCGAGAGGTGATGATACGCGACTCACG|GAATTATTGAGCGTGATGGTGAACACGGCG
TTTCCGCATCTCTTGAGATGGCCGAATTAT|AACGGTCTCACCTCCAGAGCCGTCGGATGT
GATCTCAATAATGACGGGCTCTCCCGCTAC|ATCAACCCGGTATGAAAGTAAAGCTCCTTA
GTTAATATCCTCTTAATGTAATGATCTTGT|CGGCTGGATTCCAGACCAAGGGCCCCCGAC
GTCATTGCGCCCTATGGCAGACTGTTACGG|CGAAGTACAAGATGAACCGTCAAGGACTAG
TTAATGTAATGATCTTGTCCTACAACTAAT|AGACCAAGGGCCCCCGACATCAATTCGGTT
CGGTATGAAAGTAAAGCTCCTTAGGGGGGA|ATCAGGTTGGATGGCGCTACAACTAATTCG
CTGGTCTACTTATTCACGTAGCTACAACTA|CTGAGCACATCTCTTCCTTGTGCTTTATGT
TGACGGGCTCTCCCGCTACAACTAATTCGG|ATGAAAGTAAAGCTCCTTAGGGGGGACCCG
TCAATAATGACGGGCTCTCCCGCTACAACT|ACCCGGTATGAAAGTAAAGCTCCTTAGGGG
ACCTGCTCACAGTTCCTACAACTAATTCGG|TCAGTACTACAACTAATTCGGTTGATCCGA
CTACAACTAATTCGGTTGATCCGAGAGGTG|GGTGATGAAATGGGAAGTGTCCTATGGCTG
CGGCTGGATTCCAGACCAAGGGCCCCCGAC|CCGGCCTCGATACGGAGCCCGTGAGATTAG
TGATCCGAGAGGTGTAATTCGGTTGATCCG|GAGAGGTGAGGCTACAACTAATTCGGTTGA
GTCAAAGTCTGAGCACATCTCTTCCTTGTG|CTGTTAATATCCTCTTAATGTAATGATCTT
GTAAAATCCTACAACTAATTCGGTTGATCC|CAACTAATTCGGTTGATCCGAGAGGTGGAA
CGCCTGGATATGGACTGTTAATATCCTCTT|CCGAGAGGTGGACAAACGGCTGGATTCCAG
CACGTAGCTACAACTAATTCGGTTGATCCG|TCCTTGTGCTTTATGTAAAATCCTACAACT
CTATGGCTGCTCTTTGATGGCTACAACTAA|TAAAACCAACTTGCTGGGTTATACGACTGA
ACCTCCGTCCAGGCTTCGCTTCGCTAGCTA|GTCTACAACCTACAACTAATTCGGTTGATC
TCGGTTGATCCGAGAGGTGATGAAATGGGA|GTAATTCGGTTGATCCGAGAGGTGCGGGGT
CGAGAGGTGAGGCTACAACTAATTCGGTTG|GAGAGGTGATGATACGCGACTCACGGCGGA
TCGCCTTCGTCCGCGCATAGGATCTCGCAT|GACACATTAACTTTCGCGCCTGGATATGGA
GGGGGACCCGCTTATGCAAACAGGGATTTT|AATTCGGTTGATCCGAGAGGTGCCTTTAAC
GACTACTGCAAGCCTCCTCGCACACGCATC|TTACGAATCCCCCGGGTCCATTGTCATTGC
ATGGCGCTACAACTAATTCGGTTGATCCGA|GGCAGACTGTTACGGAACCTTTCCATACAA
TTGATCCGAGAGGTGATGAAATGGGAAGTG|TTCGGTTGATCCGAGAGGTGCGGGGTCATC
GGTGTTGTTATTAACTGACGACAACGCCTA|TCGGTTGATCCGAGAGGTGATTTAACTCGT
GCGACTACTGCAAGCCTCCTCGCACACGCA|ATTTACGAATCCCCCGGGTCCATTGTCATT
TCGCATGTCAAAGTCTGAGCACATCTCTTC|TATGGACTGTTAATATCCTCTTAATGTAAT
CCTTGTGCTTTATGTAAAATCCTACAACTA|TGATCTTGTCCTACAACTAATTCGGTTGAT
GTACGTCTACAACCTACAACTAATTCGGTT|GCGTCATCTACAACTAATTCGGTTGATCCG
ATTCGGTTGATCCGAGAGGTGATGAAATGG|GTGTAATTCGGTTGATCCGAGAGGTGCGGG
GAGAGGTGTTCAGTACTACAACTAATTCGG|TCGGTTGATCCGAGAGGTGATGAAATGGGA
GATCCGAGAGGTGACGATCTCAATAATGAC|ACAGAACGGCTGCGTATCAACCCGGTATGA
CGCTTATGCAAACAGGGATTTTCCGCATCT|TGATCCGAGAGGTGCCTTTAACGGTCTCAC
GAGATTAGATACCTCCGTCCAGGCTTCGCT|GGTGCAGTACGTCTACAACCTACAACTAAT
ACCCGGTATGAAAGTAAAGCTCCTTAGGGG|CGCATCAGGTTGGATGGCGCTACAACTAAT
CTACAACTAATTCGGTTGATCCGAGAGGTG|CGCTTCGCTAGCTACAACTAATTCGGTTGA
ATTCGGTTTAGTTCCTACAACTAATTCGGT|CTCCGTCCAGGCTTCGCTTCGCTAGCTACA
ACAACTAATTCGGTTGATCCGAGAGGTGAG|CAACTAATTCGGTTGATCCGAGAGGTGATG
GGGCTCTCCCGCTACAACTAATTCGGTTGA|AAGTAAAGCTCCTTAGGGGGGACCCGCTTA
TCCGTCCAGGCTTCGCTTCGCTAGCTACAA|TACAACCTACAACTAATTCGGTTGATCCGA
CGGTTGATCCGAGAGGTGATGATACGCGAC|TGGCCGAATTATTGAGCGTGATGGTGAACA
TGTCGATTTACGAATCCCCCGGGTCCATTG|AGGACCCACCCGCATGTCTAGACGATTCCC
GCTAGCTACAACTAATTCGGTTGATCCGAG|GGTTGATCCGAGAGGTGTAATTCGGTTGAT
ACTACAACTAATTCGGTTGATCCGAGAGGT|AGGTGATGAAATGGGAAGTGTCCTATGGCT
AAGTGTCCTATGGCTGCTCTTTGATGGCTA|TCATCTGTAAAACCAACTTGCTGGGTTATA
GATTTTCCGCATCTCTTGAGATGGCCGAAT|TTTAACGGTCTCACCTCCAGAGCCGTCGGA
TCGATACGGAGCCCGTGAGATTAGATACCT|TTCGGTTGATCCGAGAGGTGCAGTACGTCT
GAAAGTAAAGCTCCTTAGGGGGGACCCGCT|TTGGATGGCGCTACAACTAATTCGGTTGAT
GGTGTAATTCGGTTGATCCGAGAGGTGCGG|GCTACAACTAATTCGGTTGATCCGAGAGGT
CATTGTCATTGCGCCCTATGGCAGACTGTT|TTCCCGAAGTACAAGATGAACCGTCAAGGA
GATACGCGACTCACGGCGGACAGAACGGCT|ATGGTGAACACGGCGACTACTGCAAGCCTC
TGCCTTTAACGGTCTCACCTCCAGAGCCGT|CATTCTGACCCCAGTCACTTGCAGCCCAGC
CGCGACTCACGGCGGACAGAACGGCTGCGT|TGAACACGGCGACTACTGCAAGCCTCCTCG
ATCCGAGAGGTGGACAAACGGCTGGATTCC|GTGGCTAACGTCTCAAGTCCGGCCTCGATA
CGATCTCAATAATGACGGGCTCTCCCGCTA|TATCAACCCGGTATGAAAGTAAAGCTCCTT
CGAAGCCATCGCCTTCGTCCGCGCATAGGA|CGTGGTAGGACACATTAACTTTCGCGCCTG
CAACTAATTCGGTTGATCCGAGAGGTGCAG|CGACTGAGTGTGAAAGATAGTAACCCATTG
GGTTGATCCGAGAGGTGAGGCTACAACTAA|GTTGATCCGAGAGGTGATGATACGCGACTC
CTACAACTAATTCGGTTGATCCGAGAGGTG|TACAACTAATTCGGTTGATCCGAGAGGTGA
TAGCGAAGCCATCGCCTTCGTCCGCGCATA|ACTCGTGGTAGGACACATTAACTTTCGCGC
TACAACTAATTCGGTTGATCCGAGAGGTGT|TAATTCGGTTGATCCGAGAGGTGAGGCTAC
TTAATATCCTCTTAATGTAATGATCTTGTC|GGCTGGATTCCAGACCAAGGGCCCCCGACA
TGTCATTGCGCCCTATGGCAGACTGTTACG|CCGAAGTACAAGATGAACCGTCAAGGACTA
CAAAGTCTGAGCACATCTCTTCCTTGTGCT|GTTAATATCCTCTTAATGTAATGATCTTGT
TTGATGGCTACAACTAATTCGGTTGATCCG|CTGGGTTATACGACTGAGTGTGAAAGATAG
ATACGCGACTCACGGCGGACAGAACGGCTG|TGGTGAACACGGCGACTACTGCAAGCCTCC
GACAACGCCTATAGATAGCGAAGCCATCGC|ATTTAACTCGTACCGACTCGTGGTAGGACA
GTAATGATCTTGTCCTACAACTAATTCGGT|AAGGGCCCCCGACATCAATTCGGTTTAGTT
TCTACAACCTACAACTAATTCGGTTGATCC|ATCTACAACTAATTCGGTTGATCCGAGAGG
TAATTCGGTTGATCCGAGAGGTGTTGTTAT|GTAAAATCCTACAACTAATTCGGTTGATCC
TCTACTTATTCACGTAGCTACAACTAATTC|GCACATCTCTTCCTTGTGCTTTATGTAAAA
GGGTCCATTGTCATTGCGCCCTATGGCAGA|GACGATTCCCGAAGTACAAGATGAACCGTC
CAAAGGGAACCTGCTCACAGTTCCTACAAC|AGAGGTGTTCAGTACTACAACTAATTCGGT
CCGTCGGATGTAAGTTGAGCGTGATTTGTC|CAGCGGATGGAATTTATAGCGAGGCGAGGA
TCCGAGAGGTGCGGGGTCATCTGTAAAACC|TTGATCCGAGAGGTGACGATCTCAATAATG
GACCAAGGGCCCCCGACATCAATTCGGTTT|GGAGCCCGTGAGATTAGATACCTCCGTCCA
TATACGACTGAGTGTGAAAGATAGTAACCC|GCTACAACTAATTCGGTTGATCCGAGAGGT
TTGCGTCATCTACAACTAATTCGGTTGATC|GAGTTCGACTACAACTAATTCGGTTGATCC
AGAGCCGTCGGATGTAAGTTGAGCGTGATT|AGCCCAGCGGATGGAATTTATAGCGAGGCG
ATTCGGTTGATCCGAGAGGTGATGATACGC|AGATGGCCGAATTATTGAGCGTGATGGTGA
TGGCTAACGTCTCAAGTCCGGCCTCGATAC|TGCTCTTTGATGGCTACAACTAATTCGGTT
AGGGCCCCCGACATCAATTCGGTTTAGTTC|CCGTGAGATTAGATACCTCCGTCCAGGCTT
GTGATTTGTCGATTTACGAATCCCCCGGGT|GAGGCGAGGACCCACCCGCATGTCTAGACG
ATTCGGTTGATCCGAGAGGTGCCTTTAACG|AACCTTTCCATACAAGCCCCATTCTGACCC
GAGGTGTTGTTATTAACTGACGACAACGCC|ATTCGGTTGATCCGAGAGGTGATTTAACTC
CATTGCGCCCTATGGCAGACTGTTACGGAA|AAGTACAAGATGAACCGTCAAGGACTAGAT
GCATGTCAAAGTCTGAGCACATCTCTTCCT|TGGACTGTTAATATCCTCTTAATGTAATGA
GAGAGGTGGCTAACGTCTCAAGTCCGGCCT|TATGGCTGCTCTTTGATGGCTACAACTAAT
TCTCAAGTCCGGCCTCGATACGGAGCCCGT|ATGGCTACAACTAATTCGGTTGATCCGAGA
GCCGAATTATTGAGCGTGATGGTGAACACG|CGTCGGATGTAAGTTGAGCGTGATTTGTCG
GGAGCCCGTGAGATTAGATACCTCCGTCCA|GATCCGAGAGGTGCAGTACGTCTACAACCT
ACAGGGATTTTCCGCATCTCTTGAGATGGC|GTGCCTTTAACGGTCTCACCTCCAGAGCCG
ATCGCCTTCGTCCGCGCATAGGATCTCGCA|GGACACATTAACTTTCGCGCCTGGATATGG
TTTGTCGATTTACGAATCCCCCGGGTCCAT|CGAGGACCCACCCGCATGTCTAGACGATTC
ACGGTCTCACCTCCAGAGCCGTCGGATGTA|CCCCAGTCACTTGCAGCCCAGCGGATGGAA
CCTCGCACACGCATCAGGTTGGATGGCGCT|GTCCATTGTCATTGCGCCCTATGGCAGACT
GAGGTGGCTAACGTCTCAAGTCCGGCCTCG|TGGCTGCTCTTTGATGGCTACAACTAATTC
TTCGGTTGATCCGAGAGGTGTTCAGTACTA|GCTACAACTAATTCGGTTGATCCGAGAGGT
ACAACTAATTCGGTTGATCCGAGAGGTGGA|AATTCGGTTTAGTTCCTACAACTAATTCGG
GACCCGCTTATGCAAACAGGGATTTTCCGC|CGGTTGATCCGAGAGGTGCCTTTAACGGTC
ATGGCTGCTCTTTGATGGCTACAACTAATT|AAACCAACTTGCTGGGTTATACGACTGAGT
TGGTCTACTTATTCACGTAGCTACAACTAA|TGAGCACATCTCTTCCTTGTGCTTTATGTA
GATCTTGTCCTACAACTAATTCGGTTGATC|CCCCCGACATCAATTCGGTTTAGTTCCTAC
TCTTAATGTAATGATCTTGTCCTACAACTA|CCAGACCAAGGGCCCCCGACATCAATTCGG
TTATTCACGTAGCTACAACTAATTCGGTTG|TCTCTTCCTTGTGCTTTATGTAAAATCCTA
CATTGCGTCATCTACAACTAATTCGGTTGA|TGGAGTTCGACTACAACTAATTCGGTTGAT
ACTAATTCGGTTGATCCGAGAGGTGGCTAA|TGAAATGGGAAGTGTCCTATGGCTGCTCTT
ACAACTAATTCGGTTGATCCGAGAGGTGGA|TAGGGGGGACCCGCTTATGCAAACAGGGAT
GAGGTGGACAAACGGCTGGATTCCAGACCA|AACGTCTCAAGTCCGGCCTCGATACGGAGC
TACAACTAATTCGGTTGATCCGAGAGGTGA|TCCGAGAGGTGTAATTCGGTTGATCCGAGA
CAGTACTACAACTAATTCGGTTGATCCGAG|CGAGAGGTGATGAAATGGGAAGTGTCCTAT
GAGAGGTGATTTAACTCGTACCGACTCGTG|TAAGCATCAAAGGGAACCTGCTCACAGTTC
AAGACCTGGTCTACTTATTCACGTAGCTAC|AAAGTCTGAGCACATCTCTTCCTTGTGCTT
GTTCAGTACTACAACTAATTCGGTTGATCC|ATCCGAGAGGTGATGAAATGGGAAGTGTCC
ATCCGAGAGGTGCCTTTAACGGTCTCACCT|ATACAAGCCCCATTCTGACCCCAGTCACTT
TCGGTTGATCCGAGAGGTGGAATAAGCATC|TAGTTCCTACAACTAATTCGGTTGATCCGA
GTGAAAGATAGTAACCCATTGCGTCATCTA|CGGTTGATCCGAGAGGTGGAGTTCGACTAC
